chr	from.id	from.coord	to.id	to.coord	tag	size
chr11	1	80000	3	200000	gap	120000
chr11	4	200000	27	1160000	domain	960000
chr11	28	1160000	28	1200000	gap	40000
chr11	29	1200000	34	1440000	domain	240000
chr11	35	1440000	35	1480000	gap	40000
chr11	36	1480000	46	1920000	domain	440000
chr11	47	1920000	50	2080000	gap	160000
chr11	51	2080000	79	3240000	domain	1160000
chr11	80	3240000	88	3600000	gap	360000
chr11	89	3600000	103	4200000	domain	600000
chr11	104	4200000	107	4360000	gap	160000
chr11	108	4360000	124	5040000	domain	680000
chr11	125	5040000	142	5760000	domain	720000
chr11	143	5760000	143	5800000	gap	40000
chr11	144	5800000	157	6360000	domain	560000
chr11	158	6360000	167	6760000	domain	400000
chr11	168	6760000	194	7840000	domain	1080000
chr11	195	7840000	198	8000000	boundary	160000
chr11	199	8000000	215	8680000	domain	680000
chr11	216	8680000	221	8920000	domain	240000
chr11	222	8920000	236	9520000	domain	600000
chr11	237	9520000	242	9760000	boundary	240000
chr11	243	9760000	257	10360000	domain	600000
chr11	258	10360000	267	10760000	domain	400000
chr11	268	10760000	293	11800000	domain	1040000
chr11	294	11800000	306	12320000	domain	520000
chr11	307	12320000	321	12920000	domain	600000
chr11	322	12920000	339	13640000	domain	720000
chr11	340	13640000	355	14280000	domain	640000
chr11	356	14280000	359	14440000	boundary	160000
chr11	360	14440000	371	14920000	domain	480000
chr11	372	14920000	380	15280000	boundary	360000
chr11	381	15280000	416	16720000	domain	1440000
chr11	417	16720000	425	17080000	domain	360000
chr11	426	17080000	432	17360000	boundary	280000
chr11	433	17360000	436	17520000	boundary	160000
chr11	437	17520000	451	18120000	domain	600000
chr11	452	18120000	470	18880000	domain	760000
chr11	471	18880000	496	19920000	domain	1040000
chr11	497	19920000	502	20160000	domain	240000
chr11	503	20160000	515	20680000	domain	520000
chr11	516	20680000	554	22240000	domain	1560000
chr11	555	22240000	569	22840000	domain	600000
chr11	570	22840000	608	24400000	domain	1560000
chr11	609	24400000	655	26280000	domain	1880000
chr11	656	26280000	665	26680000	domain	400000
chr11	666	26680000	686	27520000	domain	840000
chr11	687	27520000	732	29360000	domain	1840000
chr11	733	29360000	753	30200000	domain	840000
chr11	754	30200000	756	30320000	boundary	120000
chr11	757	30320000	771	30920000	domain	600000
chr11	772	30920000	805	32280000	domain	1360000
chr11	806	32280000	820	32880000	domain	600000
chr11	821	32880000	844	33840000	domain	960000
chr11	845	33840000	861	34520000	domain	680000
chr11	862	34520000	871	34920000	domain	400000
chr11	872	34920000	885	35480000	domain	560000
chr11	886	35480000	905	36280000	domain	800000
chr11	906	36280000	911	36520000	boundary	240000
chr11	912	36520000	917	36760000	boundary	240000
chr11	918	36760000	946	37920000	domain	1160000
chr11	947	37920000	969	38840000	domain	920000
chr11	970	38840000	982	39360000	domain	520000
chr11	983	39360000	1007	40360000	domain	1000000
chr11	1008	40360000	1035	41480000	domain	1120000
chr11	1036	41480000	1062	42560000	domain	1080000
chr11	1063	42560000	1081	43320000	domain	760000
chr11	1082	43320000	1095	43880000	domain	560000
chr11	1096	43880000	1100	44080000	boundary	200000
chr11	1101	44080000	1112	44560000	domain	480000
chr11	1113	44560000	1132	45360000	domain	800000
chr11	1133	45360000	1143	45800000	domain	440000
chr11	1144	45800000	1157	46360000	domain	560000
chr11	1158	46360000	1169	46840000	domain	480000
chr11	1170	46840000	1183	47400000	domain	560000
chr11	1184	47400000	1189	47640000	boundary	240000
chr11	1190	47640000	1195	47880000	boundary	240000
chr11	1196	47880000	1207	48360000	domain	480000
chr11	1208	48360000	1381	55320000	gap	6960000
chr11	1382	55320000	1395	55880000	domain	560000
chr11	1396	55880000	1418	56800000	domain	920000
chr11	1419	56800000	1431	57320000	domain	520000
chr11	1432	57320000	1444	57840000	domain	520000
chr11	1445	57840000	1462	58560000	domain	720000
chr11	1463	58560000	1477	59160000	domain	600000
chr11	1478	59160000	1484	59440000	boundary	280000
chr11	1485	59440000	1494	59840000	domain	400000
chr11	1495	59840000	1504	60240000	domain	400000
chr11	1505	60240000	1528	61200000	domain	960000
chr11	1529	61200000	1529	61240000	gap	40000
chr11	1530	61240000	1542	61760000	boundary	520000
chr11	1543	61760000	1552	62160000	domain	400000
chr11	1553	62160000	1557	62360000	boundary	200000
chr11	1558	62360000	1570	62880000	domain	520000
chr11	1571	62880000	1592	63760000	domain	880000
chr11	1593	63760000	1598	64000000	boundary	240000
chr11	1599	64000000	1606	64320000	domain	320000
chr11	1607	64320000	1617	64760000	domain	440000
chr11	1618	64760000	1626	65120000	domain	360000
chr11	1627	65120000	1632	65360000	boundary	240000
chr11	1633	65360000	1638	65600000	boundary	240000
chr11	1639	65600000	1644	65840000	boundary	240000
chr11	1645	65840000	1649	66040000	domain	200000
chr11	1650	66040000	1655	66280000	boundary	240000
chr11	1656	66280000	1674	67040000	domain	760000
chr11	1675	67040000	1691	67720000	domain	680000
chr11	1692	67720000	1697	67960000	gap	240000
chr11	1698	67960000	1709	68440000	domain	480000
chr11	1710	68440000	1725	69080000	domain	640000
chr11	1726	69080000	1740	69680000	domain	600000
chr11	1741	69680000	1755	70280000	domain	600000
chr11	1756	70280000	1772	70960000	domain	680000
chr11	1773	70960000	1774	71040000	gap	80000
chr11	1775	71040000	1788	71600000	domain	560000
chr11	1789	71600000	1795	71880000	gap	280000
chr11	1796	71880000	1809	72440000	domain	560000
chr11	1810	72440000	1815	72680000	domain	240000
chr11	1816	72680000	1831	73320000	domain	640000
chr11	1832	73320000	1842	73760000	domain	440000
chr11	1843	73760000	1863	74600000	domain	840000
chr11	1864	74600000	1867	74760000	boundary	160000
chr11	1868	74760000	1880	75280000	domain	520000
chr11	1881	75280000	1883	75400000	boundary	120000
chr11	1884	75400000	1887	75560000	boundary	160000
chr11	1888	75560000	1916	76720000	domain	1160000
chr11	1917	76720000	1926	77120000	domain	400000
chr11	1927	77120000	1946	77920000	domain	800000
chr11	1947	77920000	1947	77960000	gap	40000
chr11	1948	77960000	1963	78600000	domain	640000
chr11	1964	78600000	1987	79560000	domain	960000
chr11	1988	79560000	2031	81320000	domain	1760000
chr11	2032	81320000	2036	81520000	boundary	200000
chr11	2037	81520000	2066	82720000	domain	1200000
chr11	2067	82720000	2080	83280000	domain	560000
chr11	2081	83280000	2094	83840000	domain	560000
chr11	2095	83840000	2111	84520000	domain	680000
chr11	2112	84520000	2116	84720000	domain	200000
chr11	2117	84720000	2138	85600000	domain	880000
chr11	2139	85600000	2156	86320000	domain	720000
chr11	2157	86320000	2169	86840000	domain	520000
chr11	2170	86840000	2184	87440000	domain	600000
chr11	2185	87440000	2197	87960000	domain	520000
chr11	2198	87960000	2198	88000000	gap	40000
chr11	2199	88000000	2219	88840000	domain	840000
chr11	2220	88840000	2219	88840000	gap	0
chr11	2220	88840000	2251	90120000	gap	1280000
chr11	2252	90120000	2278	91200000	domain	1080000
chr11	2279	91200000	2321	92920000	domain	1720000
chr11	2322	92920000	2327	93160000	boundary	240000
chr11	2328	93160000	2344	93840000	domain	680000
chr11	2345	93840000	2360	94480000	domain	640000
chr11	2361	94480000	2375	95080000	domain	600000
chr11	2376	95080000	2393	95800000	domain	720000
chr11	2394	95800000	2409	96440000	domain	640000
chr11	2410	96440000	2427	97160000	domain	720000
chr11	2428	97160000	2474	99040000	domain	1880000
chr11	2475	99040000	2489	99640000	domain	600000
chr11	2490	99640000	2512	100560000	domain	920000
chr11	2513	100560000	2522	100960000	domain	400000
chr11	2523	100960000	2534	101440000	domain	480000
chr11	2535	101440000	2544	101840000	domain	400000
chr11	2545	101840000	2549	102040000	boundary	200000
chr11	2550	102040000	2555	102280000	domain	240000
chr11	2556	102280000	2566	102720000	domain	440000
chr11	2567	102720000	2575	103080000	domain	360000
chr11	2576	103080000	2590	103680000	domain	600000
chr11	2591	103680000	2604	104240000	domain	560000
chr11	2605	104240000	2608	104400000	boundary	160000
chr11	2609	104400000	2634	105440000	domain	1040000
chr11	2635	105440000	2647	105960000	domain	520000
chr11	2648	105960000	2686	107520000	domain	1560000
chr11	2687	107520000	2698	108000000	domain	480000
chr11	2699	108000000	2715	108680000	domain	680000
chr11	2716	108680000	2746	109920000	domain	1240000
chr11	2747	109920000	2759	110440000	domain	520000
chr11	2760	110440000	2780	111280000	domain	840000
chr11	2781	111280000	2786	111520000	boundary	240000
chr11	2787	111520000	2795	111880000	domain	360000
chr11	2796	111880000	2801	112120000	boundary	240000
chr11	2802	112120000	2830	113280000	domain	1160000
chr11	2831	113280000	2844	113840000	domain	560000
chr11	2845	113840000	2864	114640000	domain	800000
chr11	2865	114640000	2881	115320000	domain	680000
chr11	2882	115320000	2916	116720000	domain	1400000
chr11	2917	116720000	2932	117360000	domain	640000
chr11	2933	117360000	2951	118120000	domain	760000
chr11	2952	118120000	2957	118360000	boundary	240000
chr11	2958	118360000	2963	118600000	boundary	240000
chr11	2964	118600000	2982	119360000	domain	760000
chr11	2983	119360000	3002	120160000	domain	800000
chr11	3003	120160000	3006	120320000	boundary	160000
chr11	3007	120320000	3028	121200000	domain	880000
chr11	3029	121200000	3039	121640000	domain	440000
chr11	3040	121640000	3062	122560000	domain	920000
chr11	3063	122560000	3075	123080000	domain	520000
chr11	3076	123080000	3088	123600000	domain	520000
chr11	3089	123600000	3092	123760000	boundary	160000
chr11	3093	123760000	3108	124400000	domain	640000
chr11	3109	124400000	3113	124600000	boundary	200000
chr11	3114	124600000	3121	124920000	domain	320000
chr11	3122	124920000	3134	125440000	domain	520000
chr11	3135	125440000	3137	125560000	boundary	120000
chr11	3138	125560000	3145	125880000	domain	320000
chr11	3146	125880000	3155	126280000	domain	400000
chr11	3156	126280000	3198	128000000	domain	1720000
chr11	3199	128000000	3220	128880000	domain	880000
chr11	3221	128880000	3232	129360000	domain	480000
chr11	3233	129360000	3242	129760000	domain	400000
chr11	3243	129760000	3253	130200000	domain	440000
chr11	3254	130200000	3258	130400000	boundary	200000
chr11	3259	130400000	3271	130920000	domain	520000
chr11	3272	130920000	3290	131680000	domain	760000
chr11	3291	131680000	3324	133040000	domain	1360000
chr11	3325	133040000	3345	133880000	domain	840000
chr11	3346	133880000	3353	134200000	boundary	320000
chr11	3354	134200000	3375	135080000	domain	880000
