chr	from.id	from.coord	to.id	to.coord	tag	size
chr21	1	5000000	227	14080000	gap	9080000
chr21	228	14080000	236	14440000	domain	360000
chr21	237	14440000	247	14880000	domain	440000
chr21	248	14880000	252	15080000	domain	200000
chr21	253	15080000	262	15480000	domain	400000
chr21	263	15480000	265	15600000	domain	120000
chr21	266	15600000	272	15880000	domain	280000
chr21	273	15880000	283	16320000	domain	440000
chr21	284	16320000	290	16600000	domain	280000
chr21	291	16600000	309	17360000	domain	760000
chr21	310	17360000	316	17640000	domain	280000
chr21	317	17640000	332	18280000	domain	640000
chr21	333	18280000	358	19320000	domain	1040000
chr21	359	19320000	361	19440000	domain	120000
chr21	362	19440000	369	19760000	domain	320000
chr21	370	19760000	374	19960000	domain	200000
chr21	375	19960000	378	20120000	domain	160000
chr21	379	20120000	382	20280000	domain	160000
chr21	383	20280000	387	20480000	domain	200000
chr21	388	20480000	399	20960000	domain	480000
chr21	400	20960000	404	21160000	domain	200000
chr21	405	21160000	423	21920000	domain	760000
chr21	424	21920000	445	22800000	domain	880000
chr21	446	22800000	455	23200000	domain	400000
chr21	456	23200000	462	23480000	domain	280000
chr21	463	23480000	465	23600000	domain	120000
chr21	466	23600000	471	23840000	domain	240000
chr21	472	23840000	488	24520000	domain	680000
chr21	489	24520000	496	24840000	domain	320000
chr21	497	24840000	502	25080000	domain	240000
chr21	503	25080000	510	25400000	domain	320000
chr21	511	25400000	514	25560000	domain	160000
chr21	515	25560000	519	25760000	domain	200000
chr21	520	25760000	522	25880000	domain	120000
chr21	523	25880000	530	26200000	domain	320000
chr21	531	26200000	537	26480000	domain	280000
chr21	538	26480000	544	26760000	domain	280000
chr21	545	26760000	571	27840000	domain	1080000
chr21	572	27840000	576	28040000	gap	200000
chr21	577	28040000	584	28360000	domain	320000
chr21	585	28360000	594	28760000	domain	400000
chr21	595	28760000	599	28960000	domain	200000
chr21	600	28960000	610	29400000	domain	440000
chr21	611	29400000	622	29880000	domain	480000
chr21	623	29880000	652	31080000	domain	1200000
chr21	653	31080000	655	31200000	domain	120000
chr21	656	31200000	666	31640000	domain	440000
chr21	667	31640000	682	32280000	domain	640000
chr21	683	32280000	691	32640000	domain	360000
chr21	692	32640000	696	32840000	domain	200000
chr21	697	32840000	705	33200000	domain	360000
chr21	706	33200000	712	33480000	domain	280000
chr21	713	33480000	716	33640000	domain	160000
chr21	717	33640000	723	33920000	domain	280000
chr21	724	33920000	734	34360000	domain	440000
chr21	735	34360000	737	34480000	gap	120000
chr21	738	34480000	741	34640000	domain	160000
chr21	742	34640000	747	34880000	domain	240000
chr21	748	34880000	761	35440000	domain	560000
chr21	762	35440000	776	36040000	domain	600000
chr21	777	36040000	778	36120000	domain	80000
chr21	779	36120000	785	36400000	domain	280000
chr21	786	36400000	799	36960000	domain	560000
chr21	800	36960000	817	37680000	domain	720000
chr21	818	37680000	823	37920000	domain	240000
chr21	824	37920000	828	38120000	domain	200000
chr21	829	38120000	835	38400000	domain	280000
chr21	836	38400000	843	38720000	domain	320000
chr21	844	38720000	854	39160000	domain	440000
chr21	855	39160000	862	39480000	domain	320000
chr21	863	39480000	869	39760000	domain	280000
chr21	870	39760000	879	40160000	domain	400000
chr21	880	40160000	886	40440000	domain	280000
chr21	887	40440000	896	40840000	domain	400000
chr21	897	40840000	903	41120000	domain	280000
chr21	904	41120000	907	41280000	domain	160000
chr21	908	41280000	912	41480000	domain	200000
chr21	913	41480000	921	41840000	domain	360000
chr21	922	41840000	928	42120000	domain	280000
chr21	929	42120000	933	42320000	domain	200000
chr21	934	42320000	939	42560000	domain	240000
chr21	940	42560000	947	42880000	domain	320000
chr21	948	42880000	951	43040000	domain	160000
chr21	952	43040000	965	43600000	gap	560000
chr21	966	43600000	970	43800000	domain	200000
chr21	971	43800000	977	44080000	domain	280000
chr21	978	44080000	977	44080000	gap	0
chr21	978	44080000	981	44240000	gap	160000
chr21	982	44240000	994	44760000	domain	520000
chr21	995	44760000	999	44960000	domain	200000
chr21	1000	44960000	1004	45160000	domain	200000
chr21	1005	45160000	1007	45280000	domain	120000
chr21	1008	45280000	1011	45440000	domain	160000
chr21	1012	45440000	1016	45640000	domain	200000
chr21	1017	45640000	1020	45800000	domain	160000
chr21	1021	45800000	1028	46120000	domain	320000
chr21	1029	46120000	1036	46440000	domain	320000
chr21	1037	46440000	1043	46709983	domain	269983
