chr	from.id	from.coord	to.id	to.coord	tag	size
chr2	1	0	12	480000	domain	480000
chr2	13	480000	17	680000	domain	200000
chr2	18	680000	24	960000	domain	280000
chr2	25	960000	28	1120000	domain	160000
chr2	29	1120000	38	1520000	domain	400000
chr2	39	1520000	46	1840000	domain	320000
chr2	47	1840000	53	2120000	domain	280000
chr2	54	2120000	57	2280000	domain	160000
chr2	58	2280000	84	3360000	domain	1080000
chr2	85	3360000	92	3680000	domain	320000
chr2	93	3680000	99	3960000	domain	280000
chr2	100	3960000	120	4800000	domain	840000
chr2	121	4800000	125	5000000	domain	200000
chr2	126	5000000	171	6840000	domain	1840000
chr2	172	6840000	177	7080000	domain	240000
chr2	178	7080000	186	7440000	domain	360000
chr2	187	7440000	217	8680000	domain	1240000
chr2	218	8680000	228	9120000	domain	440000
chr2	229	9120000	245	9800000	domain	680000
chr2	246	9800000	253	10120000	domain	320000
chr2	254	10120000	261	10440000	domain	320000
chr2	262	10440000	267	10680000	domain	240000
chr2	268	10680000	271	10840000	domain	160000
chr2	272	10840000	278	11120000	domain	280000
chr2	279	11120000	286	11440000	domain	320000
chr2	287	11440000	292	11680000	domain	240000
chr2	293	11680000	296	11840000	domain	160000
chr2	297	11840000	318	12720000	domain	880000
chr2	319	12720000	326	13040000	domain	320000
chr2	327	13040000	342	13680000	domain	640000
chr2	343	13680000	345	13800000	domain	120000
chr2	346	13800000	361	14440000	domain	640000
chr2	362	14440000	366	14640000	domain	200000
chr2	367	14640000	371	14840000	domain	200000
chr2	372	14840000	379	15160000	domain	320000
chr2	380	15160000	390	15600000	domain	440000
chr2	391	15600000	398	15920000	domain	320000
chr2	399	15920000	413	16520000	domain	600000
chr2	414	16520000	419	16760000	domain	240000
chr2	420	16760000	442	17680000	domain	920000
chr2	443	17680000	446	17840000	domain	160000
chr2	447	17840000	454	18160000	domain	320000
chr2	455	18160000	460	18400000	domain	240000
chr2	461	18400000	469	18760000	domain	360000
chr2	470	18760000	474	18960000	domain	200000
chr2	475	18960000	484	19360000	domain	400000
chr2	485	19360000	497	19880000	domain	520000
chr2	498	19880000	503	20120000	domain	240000
chr2	504	20120000	509	20360000	domain	240000
chr2	510	20360000	516	20640000	domain	280000
chr2	517	20640000	524	20960000	domain	320000
chr2	525	20960000	529	21160000	domain	200000
chr2	530	21160000	534	21360000	domain	200000
chr2	535	21360000	537	21480000	domain	120000
chr2	538	21480000	558	22320000	domain	840000
chr2	559	22320000	584	23360000	domain	1040000
chr2	585	23360000	595	23800000	domain	440000
chr2	596	23800000	610	24400000	domain	600000
chr2	611	24400000	624	24960000	domain	560000
chr2	625	24960000	631	25240000	domain	280000
chr2	632	25240000	639	25560000	domain	320000
chr2	640	25560000	648	25920000	domain	360000
chr2	649	25920000	654	26160000	domain	240000
chr2	655	26160000	659	26360000	domain	200000
chr2	660	26360000	665	26600000	domain	240000
chr2	666	26600000	670	26800000	domain	200000
chr2	671	26800000	674	26960000	domain	160000
chr2	675	26960000	677	27080000	domain	120000
chr2	678	27080000	684	27360000	domain	280000
chr2	685	27360000	692	27680000	domain	320000
chr2	693	27680000	710	28400000	domain	720000
chr2	711	28400000	714	28560000	domain	160000
chr2	715	28560000	720	28800000	domain	240000
chr2	721	28800000	724	28960000	domain	160000
chr2	725	28960000	731	29240000	domain	280000
chr2	732	29240000	746	29840000	domain	600000
chr2	747	29840000	753	30120000	domain	280000
chr2	754	30120000	761	30440000	domain	320000
chr2	762	30440000	768	30720000	domain	280000
chr2	769	30720000	778	31120000	domain	400000
chr2	779	31120000	784	31360000	domain	240000
chr2	785	31360000	796	31840000	domain	480000
chr2	797	31840000	826	33040000	domain	1200000
chr2	827	33040000	840	33600000	domain	560000
chr2	841	33600000	852	34080000	domain	480000
chr2	853	34080000	876	35040000	domain	960000
chr2	877	35040000	895	35800000	domain	760000
chr2	896	35800000	899	35960000	domain	160000
chr2	900	35960000	908	36320000	domain	360000
chr2	909	36320000	918	36720000	domain	400000
chr2	919	36720000	935	37400000	domain	680000
chr2	936	37400000	948	37920000	domain	520000
chr2	949	37920000	957	38280000	domain	360000
chr2	958	38280000	963	38520000	domain	240000
chr2	964	38520000	982	39280000	domain	760000
chr2	983	39280000	994	39760000	domain	480000
chr2	995	39760000	1006	40240000	domain	480000
chr2	1007	40240000	1014	40560000	domain	320000
chr2	1015	40560000	1020	40800000	domain	240000
chr2	1021	40800000	1035	41400000	domain	600000
chr2	1036	41400000	1045	41800000	domain	400000
chr2	1046	41800000	1052	42080000	domain	280000
chr2	1053	42080000	1059	42360000	domain	280000
chr2	1060	42360000	1070	42800000	domain	440000
chr2	1071	42800000	1074	42960000	domain	160000
chr2	1075	42960000	1081	43240000	domain	280000
chr2	1082	43240000	1090	43600000	domain	360000
chr2	1091	43600000	1100	44000000	domain	400000
chr2	1101	44000000	1109	44360000	domain	360000
chr2	1110	44360000	1124	44960000	domain	600000
chr2	1125	44960000	1139	45560000	domain	600000
chr2	1140	45560000	1149	45960000	domain	400000
chr2	1150	45960000	1161	46440000	domain	480000
chr2	1162	46440000	1166	46640000	domain	200000
chr2	1167	46640000	1173	46920000	domain	280000
chr2	1174	46920000	1183	47320000	domain	400000
chr2	1184	47320000	1186	47440000	domain	120000
chr2	1187	47440000	1194	47760000	domain	320000
chr2	1195	47760000	1203	48120000	domain	360000
chr2	1204	48120000	1211	48440000	domain	320000
chr2	1212	48440000	1215	48600000	domain	160000
chr2	1216	48600000	1223	48920000	domain	320000
chr2	1224	48920000	1231	49240000	domain	320000
chr2	1232	49240000	1241	49640000	domain	400000
chr2	1242	49640000	1254	50160000	domain	520000
chr2	1255	50160000	1263	50520000	domain	360000
chr2	1264	50520000	1289	51560000	domain	1040000
chr2	1290	51560000	1292	51680000	domain	120000
chr2	1293	51680000	1313	52520000	domain	840000
chr2	1314	52520000	1314	52560000	gap	40000
chr2	1315	52560000	1320	52800000	domain	240000
chr2	1321	52800000	1325	53000000	domain	200000
chr2	1326	53000000	1330	53200000	domain	200000
chr2	1331	53200000	1335	53400000	domain	200000
chr2	1336	53400000	1345	53800000	domain	400000
chr2	1346	53800000	1353	54120000	domain	320000
chr2	1354	54120000	1363	54520000	domain	400000
chr2	1364	54520000	1368	54720000	domain	200000
chr2	1369	54720000	1372	54880000	domain	160000
chr2	1373	54880000	1376	55040000	domain	160000
chr2	1377	55040000	1380	55200000	domain	160000
chr2	1381	55200000	1393	55720000	domain	520000
chr2	1394	55720000	1404	56160000	domain	440000
chr2	1405	56160000	1414	56560000	domain	400000
chr2	1415	56560000	1420	56800000	domain	240000
chr2	1421	56800000	1423	56920000	domain	120000
chr2	1424	56920000	1439	57560000	domain	640000
chr2	1440	57560000	1443	57720000	domain	160000
chr2	1444	57720000	1463	58520000	domain	800000
chr2	1464	58520000	1469	58760000	domain	240000
chr2	1470	58760000	1482	59280000	domain	520000
chr2	1483	59280000	1509	60360000	domain	1080000
chr2	1510	60360000	1515	60600000	domain	240000
chr2	1516	60600000	1525	61000000	domain	400000
chr2	1526	61000000	1538	61520000	domain	520000
chr2	1539	61520000	1547	61880000	domain	360000
chr2	1548	61880000	1561	62440000	domain	560000
chr2	1562	62440000	1570	62800000	domain	360000
chr2	1571	62800000	1590	63600000	domain	800000
chr2	1591	63600000	1597	63880000	domain	280000
chr2	1598	63880000	1608	64320000	domain	440000
chr2	1609	64320000	1614	64560000	domain	240000
chr2	1615	64560000	1622	64880000	domain	320000
chr2	1623	64880000	1626	65040000	domain	160000
chr2	1627	65040000	1631	65240000	domain	200000
chr2	1632	65240000	1640	65600000	domain	360000
chr2	1641	65600000	1660	66400000	domain	800000
chr2	1661	66400000	1665	66600000	domain	200000
chr2	1666	66600000	1680	67200000	domain	600000
chr2	1681	67200000	1696	67840000	domain	640000
chr2	1697	67840000	1701	68040000	domain	200000
chr2	1702	68040000	1708	68320000	domain	280000
chr2	1709	68320000	1712	68480000	domain	160000
chr2	1713	68480000	1718	68720000	domain	240000
chr2	1719	68720000	1724	68960000	domain	240000
chr2	1725	68960000	1733	69320000	domain	360000
chr2	1734	69320000	1743	69720000	domain	400000
chr2	1744	69720000	1748	69920000	domain	200000
chr2	1749	69920000	1758	70320000	domain	400000
chr2	1759	70320000	1766	70640000	domain	320000
chr2	1767	70640000	1770	70800000	domain	160000
chr2	1771	70800000	1775	71000000	domain	200000
chr2	1776	71000000	1776	71040000	gap	40000
chr2	1777	71040000	1783	71320000	domain	280000
chr2	1784	71320000	1788	71520000	domain	200000
chr2	1789	71520000	1798	71920000	domain	400000
chr2	1799	71920000	1804	72160000	domain	240000
chr2	1805	72160000	1822	72880000	domain	720000
chr2	1823	72880000	1831	73240000	domain	360000
chr2	1832	73240000	1844	73760000	domain	520000
chr2	1845	73760000	1845	73800000	gap	40000
chr2	1846	73800000	1855	74200000	domain	400000
chr2	1856	74200000	1861	74440000	domain	240000
chr2	1862	74440000	1866	74640000	domain	200000
chr2	1867	74640000	1873	74920000	domain	280000
chr2	1874	74920000	1886	75440000	domain	520000
chr2	1887	75440000	1891	75640000	domain	200000
chr2	1892	75640000	1905	76200000	domain	560000
chr2	1906	76200000	1915	76600000	domain	400000
chr2	1916	76600000	1924	76960000	domain	360000
chr2	1925	76960000	1941	77640000	domain	680000
chr2	1942	77640000	1942	77680000	gap	40000
chr2	1943	77680000	1948	77920000	domain	240000
chr2	1949	77920000	1958	78320000	domain	400000
chr2	1959	78320000	1970	78800000	domain	480000
chr2	1971	78800000	1975	79000000	domain	200000
chr2	1976	79000000	1981	79240000	domain	240000
chr2	1982	79240000	1988	79520000	domain	280000
chr2	1989	79520000	1997	79880000	domain	360000
chr2	1998	79880000	2002	80080000	domain	200000
chr2	2003	80080000	2007	80280000	domain	200000
chr2	2008	80280000	2012	80480000	domain	200000
chr2	2013	80480000	2021	80840000	domain	360000
chr2	2022	80840000	2024	80960000	domain	120000
chr2	2025	80960000	2032	81280000	domain	320000
chr2	2033	81280000	2047	81880000	domain	600000
chr2	2048	81880000	2052	82080000	domain	200000
chr2	2053	82080000	2074	82960000	domain	880000
chr2	2075	82960000	2080	83200000	domain	240000
chr2	2081	83200000	2098	83920000	domain	720000
chr2	2099	83920000	2111	84440000	domain	520000
chr2	2112	84440000	2122	84880000	domain	440000
chr2	2123	84880000	2126	85040000	domain	160000
chr2	2127	85040000	2133	85320000	domain	280000
chr2	2134	85320000	2140	85600000	domain	280000
chr2	2141	85600000	2146	85840000	domain	240000
chr2	2147	85840000	2152	86080000	domain	240000
chr2	2153	86080000	2160	86400000	domain	320000
chr2	2161	86400000	2168	86720000	domain	320000
chr2	2169	86720000	2200	88000000	gap	1280000
chr2	2201	88000000	2205	88200000	domain	200000
chr2	2206	88200000	2214	88560000	domain	360000
chr2	2215	88560000	2219	88760000	domain	200000
chr2	2220	88760000	2220	88800000	gap	40000
chr2	2221	88800000	2224	88960000	domain	160000
chr2	2225	88960000	2372	94880000	gap	5920000
chr2	2373	94880000	2379	95160000	domain	280000
chr2	2380	95160000	2385	95400000	domain	240000
chr2	2386	95400000	2402	96080000	gap	680000
chr2	2403	96080000	2407	96280000	domain	200000
chr2	2408	96280000	2414	96560000	domain	280000
chr2	2415	96560000	2420	96800000	domain	240000
chr2	2421	96800000	2425	97000000	domain	200000
chr2	2426	97000000	2441	97640000	gap	640000
chr2	2442	97640000	2450	98000000	domain	360000
chr2	2451	98000000	2460	98400000	domain	400000
chr2	2461	98400000	2465	98600000	domain	200000
chr2	2466	98600000	2471	98840000	domain	240000
chr2	2472	98840000	2477	99080000	domain	240000
chr2	2478	99080000	2483	99320000	domain	240000
chr2	2484	99320000	2488	99520000	domain	200000
chr2	2489	99520000	2502	100080000	domain	560000
chr2	2503	100080000	2503	100120000	gap	40000
chr2	2504	100120000	2510	100400000	domain	280000
chr2	2511	100400000	2514	100560000	domain	160000
chr2	2515	100560000	2525	101000000	domain	440000
chr2	2526	101000000	2531	101240000	domain	240000
chr2	2532	101240000	2535	101400000	domain	160000
chr2	2536	101400000	2542	101680000	domain	280000
chr2	2543	101680000	2546	101840000	domain	160000
chr2	2547	101840000	2550	102000000	domain	160000
chr2	2551	102000000	2556	102240000	domain	240000
chr2	2557	102240000	2562	102480000	domain	240000
chr2	2563	102480000	2568	102720000	domain	240000
chr2	2569	102720000	2571	102840000	domain	120000
chr2	2572	102840000	2578	103120000	domain	280000
chr2	2579	103120000	2588	103520000	domain	400000
chr2	2589	103520000	2591	103640000	domain	120000
chr2	2592	103640000	2597	103880000	domain	240000
chr2	2598	103880000	2611	104440000	domain	560000
chr2	2612	104440000	2622	104880000	domain	440000
chr2	2623	104880000	2627	105080000	domain	200000
chr2	2628	105080000	2633	105320000	domain	240000
chr2	2634	105320000	2639	105560000	domain	240000
chr2	2640	105560000	2644	105760000	domain	200000
chr2	2645	105760000	2652	106080000	domain	320000
chr2	2653	106080000	2656	106240000	domain	160000
chr2	2657	106240000	2663	106520000	gap	280000
chr2	2664	106520000	2672	106880000	domain	360000
chr2	2673	106880000	2679	107160000	domain	280000
chr2	2680	107160000	2696	107840000	domain	680000
chr2	2697	107840000	2698	107920000	gap	80000
chr2	2699	107920000	2705	108200000	domain	280000
chr2	2706	108200000	2712	108480000	domain	280000
chr2	2713	108480000	2719	108760000	gap	280000
chr2	2720	108760000	2738	109520000	domain	760000
chr2	2739	109520000	2743	109720000	domain	200000
chr2	2744	109720000	2766	110640000	gap	920000
chr2	2767	110640000	2770	110800000	domain	160000
chr2	2771	110800000	2781	111240000	domain	440000
chr2	2782	111240000	2797	111880000	gap	640000
chr2	2798	111880000	2802	112080000	domain	200000
chr2	2803	112080000	2809	112360000	domain	280000
chr2	2810	112360000	2811	112440000	gap	80000
chr2	2812	112440000	2815	112600000	domain	160000
chr2	2816	112600000	2819	112760000	domain	160000
chr2	2820	112760000	2824	112960000	domain	200000
chr2	2825	112960000	2827	113080000	domain	120000
chr2	2828	113080000	2834	113360000	domain	280000
chr2	2835	113360000	2842	113680000	gap	320000
chr2	2843	113680000	2849	113960000	domain	280000
chr2	2850	113960000	2855	114200000	domain	240000
chr2	2856	114200000	2858	114320000	domain	120000
chr2	2859	114320000	2864	114560000	domain	240000
chr2	2865	114560000	2874	114960000	domain	400000
chr2	2875	114960000	2881	115240000	domain	280000
chr2	2882	115240000	2885	115400000	domain	160000
chr2	2886	115400000	2888	115520000	domain	120000
chr2	2889	115520000	2890	115600000	boundary	80000
chr2	2891	115600000	2894	115760000	domain	160000
chr2	2895	115760000	2898	115920000	domain	160000
chr2	2899	115920000	2907	116280000	domain	360000
chr2	2908	116280000	2915	116600000	domain	320000
chr2	2916	116600000	2918	116720000	domain	120000
chr2	2919	116720000	2929	117160000	domain	440000
chr2	2930	117160000	2935	117400000	domain	240000
chr2	2936	117400000	2945	117800000	domain	400000
chr2	2946	117800000	2950	118000000	domain	200000
chr2	2951	118000000	2955	118200000	domain	200000
chr2	2956	118200000	2966	118640000	domain	440000
chr2	2967	118640000	2972	118880000	domain	240000
chr2	2973	118880000	2982	119280000	domain	400000
chr2	2983	119280000	2988	119520000	domain	240000
chr2	2989	119520000	2992	119680000	domain	160000
chr2	2993	119680000	3008	120320000	domain	640000
chr2	3009	120320000	3017	120680000	domain	360000
chr2	3018	120680000	3027	121080000	domain	400000
chr2	3028	121080000	3034	121360000	domain	280000
chr2	3035	121360000	3038	121520000	domain	160000
chr2	3039	121520000	3044	121760000	domain	240000
chr2	3045	121760000	3049	121960000	domain	200000
chr2	3050	121960000	3072	122880000	domain	920000
chr2	3073	122880000	3100	124000000	domain	1120000
chr2	3101	124000000	3107	124280000	domain	280000
chr2	3108	124280000	3120	124800000	domain	520000
chr2	3121	124800000	3122	124880000	boundary	80000
chr2	3123	124880000	3131	125240000	domain	360000
chr2	3132	125240000	3137	125480000	domain	240000
chr2	3138	125480000	3145	125800000	domain	320000
chr2	3146	125800000	3154	126160000	domain	360000
chr2	3155	126160000	3156	126240000	domain	80000
chr2	3157	126240000	3162	126480000	domain	240000
chr2	3163	126480000	3169	126760000	domain	280000
chr2	3170	126760000	3175	127000000	domain	240000
chr2	3176	127000000	3183	127320000	domain	320000
chr2	3184	127320000	3188	127520000	domain	200000
chr2	3189	127520000	3193	127720000	domain	200000
chr2	3194	127720000	3197	127880000	domain	160000
chr2	3198	127880000	3204	128160000	domain	280000
chr2	3205	128160000	3208	128320000	domain	160000
chr2	3209	128320000	3218	128720000	domain	400000
chr2	3219	128720000	3231	129240000	domain	520000
chr2	3232	129240000	3235	129400000	domain	160000
chr2	3236	129400000	3249	129960000	domain	560000
chr2	3250	129960000	3256	130240000	gap	280000
chr2	3257	130240000	3260	130400000	domain	160000
chr2	3261	130400000	3268	130720000	gap	320000
chr2	3269	130720000	3279	131160000	domain	440000
chr2	3280	131160000	3309	132360000	gap	1200000
chr2	3310	132360000	3314	132560000	domain	200000
chr2	3315	132560000	3317	132680000	domain	120000
chr2	3318	132680000	3329	133160000	domain	480000
chr2	3330	133160000	3339	133560000	domain	400000
chr2	3340	133560000	3347	133880000	domain	320000
chr2	3348	133880000	3352	134080000	domain	200000
chr2	3353	134080000	3361	134440000	domain	360000
chr2	3362	134440000	3373	134920000	domain	480000
chr2	3374	134920000	3380	135200000	domain	280000
chr2	3381	135200000	3394	135760000	domain	560000
chr2	3395	135760000	3397	135880000	domain	120000
chr2	3398	135880000	3410	136400000	domain	520000
chr2	3411	136400000	3419	136760000	domain	360000
chr2	3420	136760000	3427	137080000	domain	320000
chr2	3428	137080000	3429	137160000	boundary	80000
chr2	3430	137160000	3436	137440000	domain	280000
chr2	3437	137440000	3447	137880000	domain	440000
chr2	3448	137880000	3453	138120000	domain	240000
chr2	3454	138120000	3471	138840000	domain	720000
chr2	3472	138840000	3479	139160000	domain	320000
chr2	3480	139160000	3492	139680000	domain	520000
chr2	3493	139680000	3496	139840000	domain	160000
chr2	3497	139840000	3504	140160000	domain	320000
chr2	3505	140160000	3520	140800000	domain	640000
chr2	3521	140800000	3522	140880000	boundary	80000
chr2	3523	140880000	3539	141560000	domain	680000
chr2	3540	141560000	3550	142000000	domain	440000
chr2	3551	142000000	3554	142160000	domain	160000
chr2	3555	142160000	3560	142400000	domain	240000
chr2	3561	142400000	3567	142680000	domain	280000
chr2	3568	142680000	3575	143000000	domain	320000
chr2	3576	143000000	3582	143280000	domain	280000
chr2	3583	143280000	3628	145120000	domain	1840000
chr2	3629	145120000	3634	145360000	domain	240000
chr2	3635	145360000	3650	146000000	domain	640000
chr2	3651	146000000	3655	146200000	domain	200000
chr2	3656	146200000	3658	146320000	domain	120000
chr2	3659	146320000	3668	146720000	domain	400000
chr2	3669	146720000	3699	147960000	domain	1240000
chr2	3700	147960000	3713	148520000	domain	560000
chr2	3714	148520000	3725	149000000	domain	480000
chr2	3726	149000000	3740	149600000	domain	600000
chr2	3741	149600000	3762	150480000	domain	880000
chr2	3763	150480000	3781	151240000	domain	760000
chr2	3782	151240000	3789	151560000	domain	320000
chr2	3790	151560000	3790	151600000	gap	40000
chr2	3791	151600000	3801	152040000	domain	440000
chr2	3802	152040000	3805	152200000	domain	160000
chr2	3806	152200000	3816	152640000	domain	440000
chr2	3817	152640000	3819	152760000	domain	120000
chr2	3820	152760000	3825	153000000	domain	240000
chr2	3826	153000000	3826	153040000	gap	40000
chr2	3827	153040000	3838	153520000	domain	480000
chr2	3839	153520000	3843	153720000	domain	200000
chr2	3844	153720000	3851	154040000	domain	320000
chr2	3852	154040000	3859	154360000	domain	320000
chr2	3860	154360000	3865	154600000	domain	240000
chr2	3866	154600000	3883	155320000	domain	720000
chr2	3884	155320000	3893	155720000	domain	400000
chr2	3894	155720000	3908	156320000	domain	600000
chr2	3909	156320000	3915	156600000	domain	280000
chr2	3916	156600000	3922	156880000	domain	280000
chr2	3923	156880000	3932	157280000	domain	400000
chr2	3933	157280000	3937	157480000	domain	200000
chr2	3938	157480000	3944	157760000	domain	280000
chr2	3945	157760000	3951	158040000	domain	280000
chr2	3952	158040000	3972	158880000	domain	840000
chr2	3973	158880000	4002	160080000	domain	1200000
chr2	4003	160080000	4007	160280000	domain	200000
chr2	4008	160280000	4025	161000000	domain	720000
chr2	4026	161000000	4027	161080000	domain	80000
chr2	4028	161080000	4040	161600000	domain	520000
chr2	4041	161600000	4049	161960000	domain	360000
chr2	4050	161960000	4054	162160000	domain	200000
chr2	4055	162160000	4059	162360000	domain	200000
chr2	4060	162360000	4064	162560000	domain	200000
chr2	4065	162560000	4071	162840000	domain	280000
chr2	4072	162840000	4079	163160000	domain	320000
chr2	4080	163160000	4091	163640000	domain	480000
chr2	4092	163640000	4118	164720000	domain	1080000
chr2	4119	164720000	4125	165000000	domain	280000
chr2	4126	165000000	4135	165400000	domain	400000
chr2	4136	165400000	4143	165720000	domain	320000
chr2	4144	165720000	4149	165960000	domain	240000
chr2	4150	165960000	4155	166200000	domain	240000
chr2	4156	166200000	4163	166520000	domain	320000
chr2	4164	166520000	4189	167560000	domain	1040000
chr2	4190	167560000	4203	168120000	domain	560000
chr2	4204	168120000	4208	168320000	domain	200000
chr2	4209	168320000	4219	168760000	domain	440000
chr2	4220	168760000	4224	168960000	domain	200000
chr2	4225	168960000	4236	169440000	domain	480000
chr2	4237	169440000	4245	169800000	domain	360000
chr2	4246	169800000	4259	170360000	domain	560000
chr2	4260	170360000	4273	170920000	domain	560000
chr2	4274	170920000	4279	171160000	domain	240000
chr2	4280	171160000	4286	171440000	domain	280000
chr2	4287	171440000	4303	172120000	domain	680000
chr2	4304	172120000	4312	172480000	domain	360000
chr2	4313	172480000	4320	172800000	domain	320000
chr2	4321	172800000	4325	173000000	domain	200000
chr2	4326	173000000	4331	173240000	domain	240000
chr2	4332	173240000	4335	173400000	domain	160000
chr2	4336	173400000	4352	174080000	domain	680000
chr2	4353	174080000	4359	174360000	domain	280000
chr2	4360	174360000	4368	174720000	domain	360000
chr2	4369	174720000	4375	175000000	domain	280000
chr2	4376	175000000	4383	175320000	domain	320000
chr2	4384	175320000	4392	175680000	domain	360000
chr2	4393	175680000	4402	176080000	domain	400000
chr2	4403	176080000	4416	176640000	domain	560000
chr2	4417	176640000	4421	176840000	domain	200000
chr2	4422	176840000	4429	177160000	domain	320000
chr2	4430	177160000	4444	177760000	domain	600000
chr2	4445	177760000	4453	178120000	domain	360000
chr2	4454	178120000	4462	178480000	domain	360000
chr2	4463	178480000	4466	178640000	domain	160000
chr2	4467	178640000	4467	178680000	gap	40000
chr2	4468	178680000	4480	179200000	domain	520000
chr2	4481	179200000	4481	179240000	gap	40000
chr2	4482	179240000	4485	179400000	domain	160000
chr2	4486	179400000	4494	179760000	domain	360000
chr2	4495	179760000	4502	180080000	domain	320000
chr2	4503	180080000	4527	181080000	domain	1000000
chr2	4528	181080000	4537	181480000	domain	400000
chr2	4538	181480000	4543	181720000	domain	240000
chr2	4544	181720000	4554	182160000	domain	440000
chr2	4555	182160000	4568	182720000	domain	560000
chr2	4569	182720000	4581	183240000	domain	520000
chr2	4582	183240000	4589	183560000	domain	320000
chr2	4590	183560000	4603	184120000	domain	560000
chr2	4604	184120000	4608	184320000	domain	200000
chr2	4609	184320000	4620	184800000	domain	480000
chr2	4621	184800000	4632	185280000	domain	480000
chr2	4633	185280000	4643	185720000	domain	440000
chr2	4644	185720000	4662	186480000	domain	760000
chr2	4663	186480000	4667	186680000	domain	200000
chr2	4668	186680000	4687	187480000	domain	800000
chr2	4688	187480000	4696	187840000	domain	360000
chr2	4697	187840000	4713	188520000	domain	680000
chr2	4714	188520000	4727	189080000	domain	560000
chr2	4728	189080000	4736	189440000	domain	360000
chr2	4737	189440000	4741	189640000	domain	200000
chr2	4742	189640000	4744	189760000	domain	120000
chr2	4745	189760000	4752	190080000	domain	320000
chr2	4753	190080000	4758	190320000	domain	240000
chr2	4759	190320000	4763	190520000	domain	200000
chr2	4764	190520000	4769	190760000	domain	240000
chr2	4770	190760000	4776	191040000	domain	280000
chr2	4777	191040000	4788	191520000	domain	480000
chr2	4789	191520000	4794	191760000	domain	240000
chr2	4795	191760000	4805	192200000	domain	440000
chr2	4806	192200000	4849	193960000	domain	1760000
chr2	4850	193960000	4863	194520000	domain	560000
chr2	4864	194520000	4883	195320000	domain	800000
chr2	4884	195320000	4892	195680000	domain	360000
chr2	4893	195680000	4901	196040000	domain	360000
chr2	4902	196040000	4919	196760000	domain	720000
chr2	4920	196760000	4935	197400000	domain	640000
chr2	4936	197400000	4945	197800000	domain	400000
chr2	4946	197800000	4958	198320000	domain	520000
chr2	4959	198320000	4966	198640000	domain	320000
chr2	4967	198640000	4975	199000000	domain	360000
chr2	4976	199000000	4987	199480000	domain	480000
chr2	4988	199480000	4992	199680000	domain	200000
chr2	4993	199680000	4999	199960000	domain	280000
chr2	5000	199960000	5013	200520000	domain	560000
chr2	5014	200520000	5018	200720000	domain	200000
chr2	5019	200720000	5022	200880000	domain	160000
chr2	5023	200880000	5031	201240000	domain	360000
chr2	5032	201240000	5041	201640000	domain	400000
chr2	5042	201640000	5044	201760000	domain	120000
chr2	5045	201760000	5055	202200000	domain	440000
chr2	5056	202200000	5064	202560000	domain	360000
chr2	5065	202560000	5086	203440000	domain	880000
chr2	5087	203440000	5098	203920000	domain	480000
chr2	5099	203920000	5108	204320000	domain	400000
chr2	5109	204320000	5118	204720000	domain	400000
chr2	5119	204720000	5142	205680000	domain	960000
chr2	5143	205680000	5149	205960000	domain	280000
chr2	5150	205960000	5154	206160000	domain	200000
chr2	5155	206160000	5167	206680000	domain	520000
chr2	5168	206680000	5170	206800000	domain	120000
chr2	5171	206800000	5175	207000000	domain	200000
chr2	5176	207000000	5187	207480000	domain	480000
chr2	5188	207480000	5194	207760000	domain	280000
chr2	5195	207760000	5202	208080000	domain	320000
chr2	5203	208080000	5209	208360000	domain	280000
chr2	5210	208360000	5220	208800000	domain	440000
chr2	5221	208800000	5221	208840000	gap	40000
chr2	5222	208840000	5233	209320000	domain	480000
chr2	5234	209320000	5249	209960000	domain	640000
chr2	5250	209960000	5256	210240000	domain	280000
chr2	5257	210240000	5261	210440000	domain	200000
chr2	5262	210440000	5276	211040000	domain	600000
chr2	5277	211040000	5286	211440000	domain	400000
chr2	5287	211440000	5293	211720000	domain	280000
chr2	5294	211720000	5314	212560000	domain	840000
chr2	5315	212560000	5329	213160000	domain	600000
chr2	5330	213160000	5382	215280000	domain	2120000
chr2	5383	215280000	5386	215440000	domain	160000
chr2	5387	215440000	5398	215920000	domain	480000
chr2	5399	215920000	5412	216480000	domain	560000
chr2	5413	216480000	5417	216680000	domain	200000
chr2	5418	216680000	5438	217520000	domain	840000
chr2	5439	217520000	5444	217760000	domain	240000
chr2	5445	217760000	5452	218080000	domain	320000
chr2	5453	218080000	5460	218400000	domain	320000
chr2	5461	218400000	5467	218680000	domain	280000
chr2	5468	218680000	5472	218880000	domain	200000
chr2	5473	218880000	5479	219160000	domain	280000
chr2	5480	219160000	5485	219400000	domain	240000
chr2	5486	219400000	5489	219560000	domain	160000
chr2	5490	219560000	5493	219720000	domain	160000
chr2	5494	219720000	5540	221600000	domain	1880000
chr2	5541	221600000	5550	222000000	domain	400000
chr2	5551	222000000	5567	222680000	domain	680000
chr2	5568	222680000	5574	222960000	domain	280000
chr2	5575	222960000	5591	223640000	domain	680000
chr2	5592	223640000	5599	223960000	domain	320000
chr2	5600	223960000	5608	224320000	domain	360000
chr2	5609	224320000	5626	225040000	domain	720000
chr2	5627	225040000	5641	225640000	domain	600000
chr2	5642	225640000	5656	226240000	domain	600000
chr2	5657	226240000	5670	226800000	domain	560000
chr2	5671	226800000	5675	227000000	domain	200000
chr2	5676	227000000	5678	227120000	domain	120000
chr2	5679	227120000	5684	227360000	domain	240000
chr2	5685	227360000	5691	227640000	domain	280000
chr2	5692	227640000	5697	227880000	domain	240000
chr2	5698	227880000	5716	228640000	domain	760000
chr2	5717	228640000	5727	229080000	domain	440000
chr2	5728	229080000	5732	229280000	domain	200000
chr2	5733	229280000	5744	229760000	domain	480000
chr2	5745	229760000	5749	229960000	domain	200000
chr2	5750	229960000	5755	230200000	domain	240000
chr2	5756	230200000	5765	230600000	domain	400000
chr2	5766	230600000	5770	230800000	domain	200000
chr2	5771	230800000	5777	231080000	domain	280000
chr2	5778	231080000	5786	231440000	domain	360000
chr2	5787	231440000	5790	231600000	domain	160000
chr2	5791	231600000	5795	231800000	domain	200000
chr2	5796	231800000	5808	232320000	domain	520000
chr2	5809	232320000	5814	232560000	domain	240000
chr2	5815	232560000	5821	232840000	domain	280000
chr2	5822	232840000	5831	233240000	domain	400000
chr2	5832	233240000	5837	233480000	domain	240000
chr2	5838	233480000	5848	233920000	domain	440000
chr2	5849	233920000	5853	234120000	domain	200000
chr2	5854	234120000	5863	234520000	domain	400000
chr2	5864	234520000	5878	235120000	domain	600000
chr2	5879	235120000	5886	235440000	domain	320000
chr2	5887	235440000	5890	235600000	domain	160000
chr2	5891	235600000	5894	235760000	domain	160000
chr2	5895	235760000	5908	236320000	domain	560000
chr2	5909	236320000	5927	237080000	domain	760000
chr2	5928	237080000	5935	237400000	domain	320000
chr2	5936	237400000	5940	237600000	domain	200000
chr2	5941	237600000	5945	237800000	domain	200000
chr2	5946	237800000	5956	238240000	domain	440000
chr2	5957	238240000	5959	238360000	domain	120000
chr2	5960	238360000	5970	238800000	domain	440000
chr2	5971	238800000	5976	239040000	domain	240000
chr2	5977	239040000	5985	239400000	domain	360000
chr2	5986	239400000	6000	240000000	domain	600000
chr2	6001	240000000	6004	240160000	domain	160000
chr2	6005	240160000	6011	240440000	domain	280000
chr2	6012	240440000	6017	240680000	domain	240000
chr2	6018	240680000	6018	240720000	gap	40000
chr2	6019	240720000	6024	240960000	domain	240000
chr2	6025	240960000	6025	241000000	gap	40000
chr2	6026	241000000	6042	241680000	domain	680000
chr2	6043	241680000	6047	241880000	domain	200000
chr2	6048	241880000	6052	242080000	domain	200000
chr2	6053	242080000	6055	242193529	gap	113529
