chr	from.id	from.coord	to.id	to.coord	tag	size
chr21	1	5000000	226	14040000	gap	9040000
chr21	227	14040000	231	14240000	domain	200000
chr21	232	14240000	236	14440000	domain	200000
chr21	237	14440000	251	15040000	domain	600000
chr21	252	15040000	265	15600000	domain	560000
chr21	266	15600000	272	15880000	domain	280000
chr21	273	15880000	298	16920000	domain	1040000
chr21	299	16920000	307	17280000	domain	360000
chr21	308	17280000	316	17640000	domain	360000
chr21	317	17640000	323	17920000	domain	280000
chr21	324	17920000	332	18280000	domain	360000
chr21	333	18280000	337	18480000	domain	200000
chr21	338	18480000	350	19000000	domain	520000
chr21	351	19000000	355	19200000	domain	200000
chr21	356	19200000	357	19280000	boundary	80000
chr21	358	19280000	364	19560000	domain	280000
chr21	365	19560000	376	20040000	domain	480000
chr21	377	20040000	387	20480000	domain	440000
chr21	388	20480000	398	20920000	domain	440000
chr21	399	20920000	404	21160000	domain	240000
chr21	405	21160000	410	21400000	domain	240000
chr21	411	21400000	423	21920000	domain	520000
chr21	424	21920000	439	22560000	domain	640000
chr21	440	22560000	446	22840000	domain	280000
chr21	447	22840000	452	23080000	domain	240000
chr21	453	23080000	466	23640000	domain	560000
chr21	467	23640000	471	23840000	domain	200000
chr21	472	23840000	476	24040000	domain	200000
chr21	477	24040000	484	24360000	domain	320000
chr21	485	24360000	496	24840000	domain	480000
chr21	497	24840000	502	25080000	domain	240000
chr21	503	25080000	510	25400000	domain	320000
chr21	511	25400000	514	25560000	domain	160000
chr21	515	25560000	519	25760000	domain	200000
chr21	520	25760000	530	26200000	domain	440000
chr21	531	26200000	543	26720000	domain	520000
chr21	544	26720000	546	26840000	domain	120000
chr21	547	26840000	563	27520000	domain	680000
chr21	564	27520000	571	27840000	domain	320000
chr21	572	27840000	576	28040000	gap	200000
chr21	577	28040000	584	28360000	domain	320000
chr21	585	28360000	594	28760000	domain	400000
chr21	595	28760000	602	29080000	domain	320000
chr21	603	29080000	610	29400000	domain	320000
chr21	611	29400000	626	30040000	domain	640000
chr21	627	30040000	644	30760000	domain	720000
chr21	645	30760000	652	31080000	domain	320000
chr21	653	31080000	666	31640000	domain	560000
chr21	667	31640000	682	32280000	domain	640000
chr21	683	32280000	690	32600000	domain	320000
chr21	691	32600000	696	32840000	domain	240000
chr21	697	32840000	705	33200000	domain	360000
chr21	706	33200000	712	33480000	domain	280000
chr21	713	33480000	716	33640000	domain	160000
chr21	717	33640000	723	33920000	domain	280000
chr21	724	33920000	734	34360000	domain	440000
chr21	735	34360000	737	34480000	gap	120000
chr21	738	34480000	742	34680000	domain	200000
chr21	743	34680000	747	34880000	domain	200000
chr21	748	34880000	760	35400000	domain	520000
chr21	761	35400000	766	35640000	domain	240000
chr21	767	35640000	771	35840000	domain	200000
chr21	772	35840000	778	36120000	domain	280000
chr21	779	36120000	785	36400000	domain	280000
chr21	786	36400000	793	36720000	domain	320000
chr21	794	36720000	798	36920000	domain	200000
chr21	799	36920000	813	37520000	domain	600000
chr21	814	37520000	817	37680000	domain	160000
chr21	818	37680000	835	38400000	domain	720000
chr21	836	38400000	843	38720000	domain	320000
chr21	844	38720000	854	39160000	domain	440000
chr21	855	39160000	862	39480000	domain	320000
chr21	863	39480000	869	39760000	domain	280000
chr21	870	39760000	879	40160000	domain	400000
chr21	880	40160000	885	40400000	domain	240000
chr21	886	40400000	903	41120000	domain	720000
chr21	904	41120000	907	41280000	domain	160000
chr21	908	41280000	912	41480000	domain	200000
chr21	913	41480000	915	41600000	domain	120000
chr21	916	41600000	921	41840000	domain	240000
chr21	922	41840000	928	42120000	domain	280000
chr21	929	42120000	947	42880000	domain	760000
chr21	948	42880000	951	43040000	domain	160000
chr21	952	43040000	964	43560000	gap	520000
chr21	965	43560000	977	44080000	domain	520000
chr21	978	44080000	977	44080000	gap	0
chr21	978	44080000	981	44240000	gap	160000
chr21	982	44240000	987	44480000	domain	240000
chr21	988	44480000	995	44800000	domain	320000
chr21	996	44800000	999	44960000	domain	160000
chr21	1000	44960000	1003	45120000	domain	160000
chr21	1004	45120000	1007	45280000	domain	160000
chr21	1008	45280000	1011	45440000	domain	160000
chr21	1012	45440000	1015	45600000	domain	160000
chr21	1016	45600000	1024	45960000	domain	360000
chr21	1025	45960000	1028	46120000	domain	160000
chr21	1029	46120000	1043	46709983	domain	589983
