chr	from.id	from.coord	to.id	to.coord	tag	size
chr7	1	0	1	40000	gap	40000
chr7	2	40000	22	880000	domain	840000
chr7	23	880000	29	1160000	boundary	280000
chr7	30	1160000	39	1560000	domain	400000
chr7	40	1560000	60	2400000	domain	840000
chr7	61	2400000	67	2680000	boundary	280000
chr7	68	2680000	71	2840000	boundary	160000
chr7	72	2840000	82	3280000	domain	440000
chr7	83	3280000	115	4600000	domain	1320000
chr7	116	4600000	119	4760000	boundary	160000
chr7	120	4760000	130	5200000	domain	440000
chr7	131	5200000	147	5880000	domain	680000
chr7	148	5880000	150	6000000	gap	120000
chr7	151	6000000	168	6720000	domain	720000
chr7	169	6720000	175	7000000	gap	280000
chr7	176	7000000	189	7560000	domain	560000
chr7	190	7560000	208	8320000	domain	760000
chr7	209	8320000	219	8760000	domain	440000
chr7	220	8760000	230	9200000	domain	440000
chr7	231	9200000	261	10440000	domain	1240000
chr7	262	10440000	272	10880000	domain	440000
chr7	273	10880000	284	11360000	domain	480000
chr7	285	11360000	296	11840000	domain	480000
chr7	297	11840000	313	12520000	domain	680000
chr7	314	12520000	332	13280000	domain	760000
chr7	333	13280000	367	14680000	domain	1400000
chr7	368	14680000	379	15160000	domain	480000
chr7	380	15160000	402	16080000	domain	920000
chr7	403	16080000	416	16640000	domain	560000
chr7	417	16640000	423	16920000	domain	280000
chr7	424	16920000	442	17680000	domain	760000
chr7	443	17680000	459	18360000	domain	680000
chr7	460	18360000	465	18600000	domain	240000
chr7	466	18600000	478	19120000	domain	520000
chr7	479	19120000	492	19680000	domain	560000
chr7	493	19680000	518	20720000	domain	1040000
chr7	519	20720000	531	21240000	domain	520000
chr7	532	21240000	552	22080000	domain	840000
chr7	553	22080000	563	22520000	domain	440000
chr7	564	22520000	578	23120000	domain	600000
chr7	579	23120000	589	23560000	domain	440000
chr7	590	23560000	594	23760000	domain	200000
chr7	595	23760000	608	24320000	domain	560000
chr7	609	24320000	619	24760000	domain	440000
chr7	620	24760000	629	25160000	domain	400000
chr7	630	25160000	647	25880000	domain	720000
chr7	648	25880000	659	26360000	domain	480000
chr7	660	26360000	667	26680000	domain	320000
chr7	668	26680000	680	27200000	domain	520000
chr7	681	27200000	690	27600000	domain	400000
chr7	691	27600000	704	28160000	domain	560000
chr7	705	28160000	723	28920000	domain	760000
chr7	724	28920000	742	29680000	domain	760000
chr7	743	29680000	743	29720000	gap	40000
chr7	744	29720000	753	30120000	domain	400000
chr7	754	30120000	766	30640000	domain	520000
chr7	767	30640000	779	31160000	domain	520000
chr7	780	31160000	794	31760000	domain	600000
chr7	795	31760000	805	32200000	domain	440000
chr7	806	32200000	817	32680000	domain	480000
chr7	818	32680000	819	32760000	gap	80000
chr7	820	32760000	824	32960000	domain	200000
chr7	825	32960000	825	33000000	gap	40000
chr7	826	33000000	849	33960000	domain	960000
chr7	850	33960000	877	35080000	domain	1120000
chr7	878	35080000	881	35240000	gap	160000
chr7	882	35240000	891	35640000	domain	400000
chr7	892	35640000	898	35920000	domain	280000
chr7	899	35920000	910	36400000	domain	480000
chr7	911	36400000	930	37200000	domain	800000
chr7	931	37200000	947	37880000	domain	680000
chr7	948	37880000	960	38400000	domain	520000
chr7	961	38400000	969	38760000	domain	360000
chr7	970	38760000	988	39520000	domain	760000
chr7	989	39520000	1005	40200000	domain	680000
chr7	1006	40200000	1026	41040000	domain	840000
chr7	1027	41040000	1048	41920000	domain	880000
chr7	1049	41920000	1073	42920000	domain	1000000
chr7	1074	42920000	1099	43960000	domain	1040000
chr7	1100	43960000	1101	44040000	gap	80000
chr7	1102	44040000	1114	44560000	domain	520000
chr7	1115	44560000	1129	45160000	domain	600000
chr7	1130	45160000	1143	45720000	domain	560000
chr7	1144	45720000	1146	45840000	gap	120000
chr7	1147	45840000	1159	46360000	domain	520000
chr7	1160	46360000	1181	47240000	domain	880000
chr7	1182	47240000	1198	47920000	domain	680000
chr7	1199	47920000	1204	48160000	domain	240000
chr7	1205	48160000	1221	48840000	domain	680000
chr7	1222	48840000	1222	48880000	gap	40000
chr7	1223	48880000	1234	49360000	domain	480000
chr7	1235	49360000	1247	49880000	boundary	520000
chr7	1248	49880000	1249	49960000	boundary	80000
chr7	1250	49960000	1261	50440000	domain	480000
chr7	1262	50440000	1279	51160000	domain	720000
chr7	1280	51160000	1285	51400000	domain	240000
chr7	1286	51400000	1307	52280000	domain	880000
chr7	1308	52280000	1328	53120000	domain	840000
chr7	1329	53120000	1329	53160000	gap	40000
chr7	1330	53160000	1353	54120000	domain	960000
chr7	1354	54120000	1355	54200000	boundary	80000
chr7	1356	54200000	1369	54760000	domain	560000
chr7	1370	54760000	1382	55280000	domain	520000
chr7	1383	55280000	1392	55680000	domain	400000
chr7	1393	55680000	1394	55760000	gap	80000
chr7	1395	55760000	1408	56320000	domain	560000
chr7	1409	56320000	1428	57120000	gap	800000
chr7	1429	57120000	1437	57480000	domain	360000
chr7	1438	57480000	1575	63000000	gap	5520000
chr7	1576	63000000	1581	63240000	domain	240000
chr7	1582	63240000	1596	63840000	gap	600000
chr7	1597	63840000	1606	64240000	domain	400000
chr7	1607	64240000	1625	65000000	domain	760000
chr7	1626	65000000	1631	65240000	gap	240000
chr7	1632	65240000	1637	65480000	domain	240000
chr7	1638	65480000	1645	65800000	gap	320000
chr7	1646	65800000	1663	66520000	domain	720000
chr7	1664	66520000	1676	67040000	domain	520000
chr7	1677	67040000	1683	67320000	gap	280000
chr7	1684	67320000	1727	69080000	domain	1760000
chr7	1728	69080000	1751	70040000	domain	960000
chr7	1752	70040000	1770	70800000	domain	760000
chr7	1771	70800000	1794	71760000	domain	960000
chr7	1795	71760000	1815	72600000	domain	840000
chr7	1816	72600000	1833	73320000	gap	720000
chr7	1834	73320000	1843	73720000	domain	400000
chr7	1844	73720000	1851	74040000	boundary	320000
chr7	1852	74040000	1868	74720000	domain	680000
chr7	1869	74720000	1888	75520000	gap	800000
chr7	1889	75520000	1911	76440000	domain	920000
chr7	1912	76440000	1929	77160000	gap	720000
chr7	1930	77160000	1941	77640000	domain	480000
chr7	1942	77640000	1945	77800000	boundary	160000
chr7	1946	77800000	1948	77920000	boundary	120000
chr7	1949	77920000	1963	78520000	domain	600000
chr7	1964	78520000	1981	79240000	domain	720000
chr7	1982	79240000	2001	80040000	domain	800000
chr7	2002	80040000	2017	80680000	domain	640000
chr7	2018	80680000	2037	81480000	domain	800000
chr7	2038	81480000	2051	82040000	domain	560000
chr7	2052	82040000	2069	82760000	domain	720000
chr7	2070	82760000	2082	83280000	domain	520000
chr7	2083	83280000	2097	83880000	domain	600000
chr7	2098	83880000	2126	85040000	domain	1160000
chr7	2127	85040000	2147	85880000	domain	840000
chr7	2148	85880000	2159	86360000	domain	480000
chr7	2160	86360000	2172	86880000	domain	520000
chr7	2173	86880000	2182	87280000	domain	400000
chr7	2183	87280000	2186	87440000	domain	160000
chr7	2187	87440000	2205	88200000	domain	760000
chr7	2206	88200000	2221	88840000	domain	640000
chr7	2222	88840000	2253	90120000	domain	1280000
chr7	2254	90120000	2254	90160000	gap	40000
chr7	2255	90160000	2277	91080000	domain	920000
chr7	2278	91080000	2296	91840000	domain	760000
chr7	2297	91840000	2314	92560000	domain	720000
chr7	2315	92560000	2329	93160000	domain	600000
chr7	2330	93160000	2342	93680000	domain	520000
chr7	2343	93680000	2357	94280000	domain	600000
chr7	2358	94280000	2361	94440000	boundary	160000
chr7	2362	94440000	2387	95480000	domain	1040000
chr7	2388	95480000	2393	95720000	domain	240000
chr7	2394	95720000	2397	95880000	boundary	160000
chr7	2398	95880000	2427	97080000	domain	1200000
chr7	2428	97080000	2447	97880000	domain	800000
chr7	2448	97880000	2450	98000000	gap	120000
chr7	2451	98000000	2460	98400000	domain	400000
chr7	2461	98400000	2472	98880000	domain	480000
chr7	2473	98880000	2486	99440000	domain	560000
chr7	2487	99440000	2507	100280000	domain	840000
chr7	2508	100280000	2508	100320000	gap	40000
chr7	2509	100320000	2522	100880000	domain	560000
chr7	2523	100880000	2532	101280000	domain	400000
chr7	2533	101280000	2538	101520000	boundary	240000
chr7	2539	101520000	2558	102320000	domain	800000
chr7	2559	102320000	2570	102800000	gap	480000
chr7	2571	102800000	2579	103160000	domain	360000
chr7	2580	103160000	2582	103280000	gap	120000
chr7	2583	103280000	2605	104200000	domain	920000
chr7	2606	104200000	2623	104920000	domain	720000
chr7	2624	104920000	2638	105520000	domain	600000
chr7	2639	105520000	2654	106160000	domain	640000
chr7	2655	106160000	2679	107160000	domain	1000000
chr7	2680	107160000	2694	107760000	domain	600000
chr7	2695	107760000	2697	107880000	boundary	120000
chr7	2698	107880000	2704	108160000	domain	280000
chr7	2705	108160000	2714	108560000	domain	400000
chr7	2715	108560000	2745	109800000	domain	1240000
chr7	2746	109800000	2746	109840000	gap	40000
chr7	2747	109840000	2794	111760000	domain	1920000
chr7	2795	111760000	2812	112480000	domain	720000
chr7	2813	112480000	2824	112960000	domain	480000
chr7	2825	112960000	2844	113760000	domain	800000
chr7	2845	113760000	2850	114000000	boundary	240000
chr7	2851	114000000	2868	114720000	domain	720000
chr7	2869	114720000	2903	116120000	domain	1400000
chr7	2904	116120000	2922	116880000	domain	760000
chr7	2923	116880000	2930	117200000	domain	320000
chr7	2931	117200000	2935	117400000	boundary	200000
chr7	2936	117400000	2943	117720000	domain	320000
chr7	2944	117720000	2956	118240000	domain	520000
chr7	2957	118240000	2981	119240000	domain	1000000
chr7	2982	119240000	2995	119800000	domain	560000
chr7	2996	119800000	3019	120760000	domain	960000
chr7	3020	120760000	3024	120960000	domain	200000
chr7	3025	120960000	3028	121120000	domain	160000
chr7	3029	121120000	3034	121360000	domain	240000
chr7	3035	121360000	3039	121560000	domain	200000
chr7	3040	121560000	3051	122040000	domain	480000
chr7	3052	122040000	3064	122560000	domain	520000
chr7	3065	122560000	3087	123480000	domain	920000
chr7	3088	123480000	3099	123960000	domain	480000
chr7	3100	123960000	3122	124880000	domain	920000
chr7	3123	124880000	3142	125680000	domain	800000
chr7	3143	125680000	3157	126280000	domain	600000
chr7	3158	126280000	3169	126760000	domain	480000
chr7	3170	126760000	3183	127320000	domain	560000
chr7	3184	127320000	3189	127560000	domain	240000
chr7	3190	127560000	3214	128560000	domain	1000000
chr7	3215	128560000	3216	128640000	gap	80000
chr7	3217	128640000	3228	129120000	domain	480000
chr7	3229	129120000	3240	129600000	domain	480000
chr7	3241	129600000	3252	130080000	domain	480000
chr7	3253	130080000	3271	130840000	domain	760000
chr7	3272	130840000	3292	131680000	domain	840000
chr7	3293	131680000	3307	132280000	domain	600000
chr7	3308	132280000	3317	132680000	domain	400000
chr7	3318	132680000	3360	134400000	domain	1720000
chr7	3361	134400000	3365	134600000	boundary	200000
chr7	3366	134600000	3380	135200000	domain	600000
chr7	3381	135200000	3391	135640000	domain	440000
chr7	3392	135640000	3440	137600000	domain	1960000
chr7	3441	137600000	3451	138040000	domain	440000
chr7	3452	138040000	3471	138840000	domain	800000
chr7	3472	138840000	3486	139440000	domain	600000
chr7	3487	139440000	3501	140040000	domain	600000
chr7	3502	140040000	3512	140480000	domain	440000
chr7	3513	140480000	3517	140680000	domain	200000
chr7	3518	140680000	3526	141040000	domain	360000
chr7	3527	141040000	3544	141760000	domain	720000
chr7	3545	141760000	3559	142360000	domain	600000
chr7	3560	142360000	3571	142840000	domain	480000
chr7	3572	142840000	3575	143000000	domain	160000
chr7	3576	143000000	3588	143520000	domain	520000
chr7	3589	143520000	3597	143880000	gap	360000
chr7	3598	143880000	3604	144160000	domain	280000
chr7	3605	144160000	3610	144400000	gap	240000
chr7	3611	144400000	3627	145080000	domain	680000
chr7	3628	145080000	3653	146120000	domain	1040000
chr7	3654	146120000	3706	148240000	domain	2120000
chr7	3707	148240000	3712	148480000	domain	240000
chr7	3713	148480000	3725	149000000	domain	520000
chr7	3726	149000000	3728	149120000	boundary	120000
chr7	3729	149120000	3747	149880000	domain	760000
chr7	3748	149880000	3758	150320000	gap	440000
chr7	3759	150320000	3772	150880000	domain	560000
chr7	3773	150880000	3776	151040000	boundary	160000
chr7	3777	151040000	3794	151760000	domain	720000
chr7	3795	151760000	3805	152200000	domain	440000
chr7	3806	152200000	3806	152240000	gap	40000
chr7	3807	152240000	3819	152760000	domain	520000
chr7	3820	152760000	3821	152840000	gap	80000
chr7	3822	152840000	3843	153720000	domain	880000
chr7	3844	153720000	3843	153720000	gap	0
chr7	3844	153720000	3854	154160000	gap	440000
chr7	3855	154160000	3870	154800000	domain	640000
chr7	3871	154800000	3884	155360000	domain	560000
chr7	3885	155360000	3895	155800000	domain	440000
chr7	3896	155800000	3921	156840000	domain	1040000
chr7	3922	156840000	3935	157400000	domain	560000
chr7	3936	157400000	3960	158400000	domain	1000000
chr7	3961	158400000	3984	159345973	domain	945973
