chr	from.id	from.coord	to.id	to.coord	tag	size
chr4	1	0	2	80000	gap	80000
chr4	3	80000	25	1000000	domain	920000
chr4	26	1000000	26	1040000	gap	40000
chr4	27	1040000	42	1680000	domain	640000
chr4	43	1680000	48	1920000	boundary	240000
chr4	49	1920000	55	2200000	domain	280000
chr4	56	2200000	62	2480000	domain	280000
chr4	63	2480000	69	2760000	boundary	280000
chr4	70	2760000	88	3520000	domain	760000
chr4	89	3520000	90	3600000	gap	80000
chr4	91	3600000	97	3880000	domain	280000
chr4	98	3880000	104	4160000	gap	280000
chr4	105	4160000	125	5000000	domain	840000
chr4	126	5000000	148	5920000	domain	920000
chr4	149	5920000	155	6200000	boundary	280000
chr4	156	6200000	164	6560000	domain	360000
chr4	165	6560000	178	7120000	domain	560000
chr4	179	7120000	194	7760000	domain	640000
chr4	195	7760000	215	8600000	domain	840000
chr4	216	8600000	216	8640000	gap	40000
chr4	217	8640000	224	8960000	domain	320000
chr4	225	8960000	244	9760000	gap	800000
chr4	245	9760000	264	10560000	domain	800000
chr4	265	10560000	294	11760000	domain	1200000
chr4	295	11760000	318	12720000	domain	960000
chr4	319	12720000	341	13640000	domain	920000
chr4	342	13640000	380	15200000	domain	1560000
chr4	381	15200000	387	15480000	domain	280000
chr4	388	15480000	391	15640000	boundary	160000
chr4	392	15640000	407	16280000	domain	640000
chr4	408	16280000	437	17480000	domain	1200000
chr4	438	17480000	466	18640000	domain	1160000
chr4	467	18640000	480	19200000	domain	560000
chr4	481	19200000	506	20240000	domain	1040000
chr4	507	20240000	518	20720000	domain	480000
chr4	519	20720000	538	21520000	domain	800000
chr4	539	21520000	544	21760000	boundary	240000
chr4	545	21760000	560	22400000	domain	640000
chr4	561	22400000	569	22760000	domain	360000
chr4	570	22760000	590	23600000	domain	840000
chr4	591	23600000	611	24440000	domain	840000
chr4	612	24440000	629	25160000	domain	720000
chr4	630	25160000	635	25400000	boundary	240000
chr4	636	25400000	648	25920000	domain	520000
chr4	649	25920000	661	26440000	domain	520000
chr4	662	26440000	676	27040000	domain	600000
chr4	677	27040000	692	27680000	domain	640000
chr4	693	27680000	727	29080000	domain	1400000
chr4	728	29080000	767	30680000	domain	1600000
chr4	768	30680000	795	31800000	domain	1120000
chr4	796	31800000	796	31840000	gap	40000
chr4	797	31840000	820	32800000	domain	960000
chr4	821	32800000	821	32840000	gap	40000
chr4	822	32840000	869	34760000	domain	1920000
chr4	870	34760000	871	34840000	gap	80000
chr4	872	34840000	900	36000000	domain	1160000
chr4	901	36000000	910	36400000	domain	400000
chr4	911	36400000	936	37440000	domain	1040000
chr4	937	37440000	951	38040000	domain	600000
chr4	952	38040000	969	38760000	domain	720000
chr4	970	38760000	971	38840000	boundary	80000
chr4	972	38840000	980	39200000	domain	360000
chr4	981	39200000	986	39440000	boundary	240000
chr4	987	39440000	1001	40040000	domain	600000
chr4	1002	40040000	1008	40320000	boundary	280000
chr4	1009	40320000	1022	40880000	domain	560000
chr4	1023	40880000	1031	41240000	domain	360000
chr4	1032	41240000	1048	41920000	domain	680000
chr4	1049	41920000	1064	42560000	domain	640000
chr4	1065	42560000	1075	43000000	domain	440000
chr4	1076	43000000	1117	44680000	domain	1680000
chr4	1118	44680000	1137	45480000	domain	800000
chr4	1138	45480000	1168	46720000	domain	1240000
chr4	1169	46720000	1186	47440000	domain	720000
chr4	1187	47440000	1190	47600000	boundary	160000
chr4	1191	47600000	1199	47960000	domain	360000
chr4	1200	47960000	1204	48160000	boundary	200000
chr4	1205	48160000	1227	49080000	domain	920000
chr4	1228	49080000	1296	51840000	gap	2760000
chr4	1297	51840000	1327	53080000	domain	1240000
chr4	1328	53080000	1357	54280000	domain	1200000
chr4	1358	54280000	1374	54960000	domain	680000
chr4	1375	54960000	1397	55880000	domain	920000
chr4	1398	55880000	1409	56360000	domain	480000
chr4	1410	56360000	1426	57040000	domain	680000
chr4	1427	57040000	1472	58880000	domain	1840000
chr4	1473	58880000	1473	58920000	gap	40000
chr4	1474	58920000	1480	59200000	domain	280000
chr4	1481	59200000	1506	60240000	domain	1040000
chr4	1507	60240000	1512	60480000	boundary	240000
chr4	1513	60480000	1570	62800000	domain	2320000
chr4	1571	62800000	1588	63520000	domain	720000
chr4	1589	63520000	1616	64640000	domain	1120000
chr4	1617	64640000	1685	67400000	domain	2760000
chr4	1686	67400000	1692	67680000	boundary	280000
chr4	1693	67680000	1713	68520000	domain	840000
chr4	1714	68520000	1717	68680000	gap	160000
chr4	1718	68680000	1730	69200000	domain	520000
chr4	1731	69200000	1736	69440000	gap	240000
chr4	1737	69440000	1764	70560000	domain	1120000
chr4	1765	70560000	1776	71040000	domain	480000
chr4	1777	71040000	1794	71760000	domain	720000
chr4	1795	71760000	1807	72280000	domain	520000
chr4	1808	72280000	1826	73040000	domain	760000
chr4	1827	73040000	1832	73280000	boundary	240000
chr4	1833	73280000	1854	74160000	domain	880000
chr4	1855	74160000	1871	74840000	domain	680000
chr4	1872	74840000	1888	75520000	domain	680000
chr4	1889	75520000	1897	75880000	domain	360000
chr4	1898	75880000	1900	76000000	boundary	120000
chr4	1901	76000000	1903	76120000	boundary	120000
chr4	1904	76120000	1927	77080000	domain	960000
chr4	1928	77080000	1931	77240000	boundary	160000
chr4	1932	77240000	1943	77720000	domain	480000
chr4	1944	77720000	1948	77920000	boundary	200000
chr4	1949	77920000	1965	78600000	domain	680000
chr4	1966	78600000	1973	78920000	domain	320000
chr4	1974	78920000	1998	79920000	domain	1000000
chr4	1999	79920000	1999	79960000	gap	40000
chr4	2000	79960000	2027	81080000	domain	1120000
chr4	2028	81080000	2034	81360000	domain	280000
chr4	2035	81360000	2059	82360000	domain	1000000
chr4	2060	82360000	2076	83040000	domain	680000
chr4	2077	83040000	2087	83480000	domain	440000
chr4	2088	83480000	2091	83640000	boundary	160000
chr4	2092	83640000	2113	84520000	domain	880000
chr4	2114	84520000	2125	85000000	domain	480000
chr4	2126	85000000	2151	86040000	domain	1040000
chr4	2152	86040000	2162	86480000	domain	440000
chr4	2163	86480000	2173	86920000	domain	440000
chr4	2174	86920000	2181	87240000	boundary	320000
chr4	2182	87240000	2183	87320000	boundary	80000
chr4	2184	87320000	2187	87480000	boundary	160000
chr4	2188	87480000	2200	88000000	domain	520000
chr4	2201	88000000	2213	88520000	domain	520000
chr4	2214	88520000	2217	88680000	boundary	160000
chr4	2218	88680000	2228	89120000	domain	440000
chr4	2229	89120000	2258	90320000	domain	1200000
chr4	2259	90320000	2310	92400000	domain	2080000
chr4	2311	92400000	2344	93760000	domain	1360000
chr4	2345	93760000	2355	94200000	domain	440000
chr4	2356	94200000	2365	94600000	domain	400000
chr4	2366	94600000	2379	95160000	domain	560000
chr4	2380	95160000	2458	98320000	domain	3160000
chr4	2459	98320000	2459	98360000	gap	40000
chr4	2460	98360000	2477	99080000	domain	720000
chr4	2478	99080000	2488	99520000	domain	440000
chr4	2489	99520000	2500	100000000	domain	480000
chr4	2501	100000000	2521	100840000	domain	840000
chr4	2522	100840000	2558	102320000	domain	1480000
chr4	2559	102320000	2579	103160000	domain	840000
chr4	2580	103160000	2598	103920000	domain	760000
chr4	2599	103920000	2622	104880000	domain	960000
chr4	2623	104880000	2637	105480000	domain	600000
chr4	2638	105480000	2643	105720000	domain	240000
chr4	2644	105720000	2659	106360000	domain	640000
chr4	2660	106360000	2693	107720000	domain	1360000
chr4	2694	107720000	2699	107960000	boundary	240000
chr4	2700	107960000	2716	108640000	domain	680000
chr4	2717	108640000	2735	109400000	domain	760000
chr4	2736	109400000	2750	110000000	domain	600000
chr4	2751	110000000	2765	110600000	domain	600000
chr4	2766	110600000	2791	111640000	domain	1040000
chr4	2792	111640000	2801	112040000	domain	400000
chr4	2802	112040000	2817	112680000	domain	640000
chr4	2818	112680000	2826	113040000	boundary	360000
chr4	2827	113040000	2832	113280000	boundary	240000
chr4	2833	113280000	2860	114400000	domain	1120000
chr4	2861	114400000	2869	114760000	domain	360000
chr4	2870	114760000	2903	116120000	domain	1360000
chr4	2904	116120000	2905	116200000	boundary	80000
chr4	2906	116200000	2960	118400000	domain	2200000
chr4	2961	118400000	2967	118680000	gap	280000
chr4	2968	118680000	2983	119320000	domain	640000
chr4	2984	119320000	2987	119480000	gap	160000
chr4	2988	119480000	3002	120080000	domain	600000
chr4	3003	120080000	3029	121160000	domain	1080000
chr4	3030	121160000	3045	121800000	domain	640000
chr4	3046	121800000	3076	123040000	domain	1240000
chr4	3077	123040000	3108	124320000	domain	1280000
chr4	3109	124320000	3132	125280000	domain	960000
chr4	3133	125280000	3190	127600000	domain	2320000
chr4	3191	127600000	3194	127760000	boundary	160000
chr4	3195	127760000	3203	128120000	boundary	360000
chr4	3204	128120000	3228	129120000	domain	1000000
chr4	3229	129120000	3271	130840000	domain	1720000
chr4	3272	130840000	3291	131640000	domain	800000
chr4	3292	131640000	3299	131960000	gap	320000
chr4	3300	131960000	3323	132920000	domain	960000
chr4	3324	132920000	3326	133040000	boundary	120000
chr4	3327	133040000	3374	134960000	domain	1920000
chr4	3375	134960000	3403	136120000	domain	1160000
chr4	3404	136120000	3404	136160000	gap	40000
chr4	3405	136160000	3426	137040000	domain	880000
chr4	3427	137040000	3474	138960000	domain	1920000
chr4	3475	138960000	3491	139640000	domain	680000
chr4	3492	139640000	3509	140360000	domain	720000
chr4	3510	140360000	3529	141160000	domain	800000
chr4	3530	141160000	3552	142080000	domain	920000
chr4	3553	142080000	3572	142880000	domain	800000
chr4	3573	142880000	3595	143800000	domain	920000
chr4	3596	143800000	3604	144160000	gap	360000
chr4	3605	144160000	3627	145080000	domain	920000
chr4	3628	145080000	3655	146200000	domain	1120000
chr4	3656	146200000	3677	147080000	domain	880000
chr4	3678	147080000	3691	147640000	domain	560000
chr4	3692	147640000	3697	147880000	boundary	240000
chr4	3698	147880000	3732	149280000	domain	1400000
chr4	3733	149280000	3748	149920000	domain	640000
chr4	3749	149920000	3777	151080000	domain	1160000
chr4	3778	151080000	3794	151760000	domain	680000
chr4	3795	151760000	3810	152400000	domain	640000
chr4	3811	152400000	3819	152760000	domain	360000
chr4	3820	152760000	3828	153120000	domain	360000
chr4	3829	153120000	3833	153320000	domain	200000
chr4	3834	153320000	3843	153720000	domain	400000
chr4	3844	153720000	3863	154520000	domain	800000
chr4	3864	154520000	3884	155360000	domain	840000
chr4	3885	155360000	3895	155800000	domain	440000
chr4	3896	155800000	3899	155960000	boundary	160000
chr4	3900	155960000	3911	156440000	domain	480000
chr4	3912	156440000	3930	157200000	domain	760000
chr4	3931	157200000	3949	157960000	domain	760000
chr4	3950	157960000	3967	158680000	domain	720000
chr4	3968	158680000	3987	159480000	domain	800000
chr4	3988	159480000	4031	161240000	domain	1760000
chr4	4032	161240000	4061	162440000	domain	1200000
chr4	4062	162440000	4089	163560000	domain	1120000
chr4	4090	163560000	4106	164240000	domain	680000
chr4	4107	164240000	4107	164280000	gap	40000
chr4	4108	164280000	4131	165240000	domain	960000
chr4	4132	165240000	4132	165280000	gap	40000
chr4	4133	165280000	4154	166160000	domain	880000
chr4	4155	166160000	4188	167520000	domain	1360000
chr4	4189	167520000	4204	168160000	domain	640000
chr4	4205	168160000	4223	168920000	domain	760000
chr4	4224	168920000	4240	169600000	domain	680000
chr4	4241	169600000	4244	169760000	boundary	160000
chr4	4245	169760000	4253	170120000	domain	360000
chr4	4254	170120000	4273	170920000	domain	800000
chr4	4274	170920000	4323	172920000	domain	2000000
chr4	4324	172920000	4338	173520000	domain	600000
chr4	4339	173520000	4355	174200000	domain	680000
chr4	4356	174200000	4368	174720000	domain	520000
chr4	4369	174720000	4389	175560000	domain	840000
chr4	4390	175560000	4398	175920000	domain	360000
chr4	4399	175920000	4409	176360000	domain	440000
chr4	4410	176360000	4432	177280000	domain	920000
chr4	4433	177280000	4466	178640000	domain	1360000
chr4	4467	178640000	4489	179560000	domain	920000
chr4	4490	179560000	4514	180560000	domain	1000000
chr4	4515	180560000	4539	181560000	domain	1000000
chr4	4540	181560000	4572	182880000	domain	1320000
chr4	4573	182880000	4586	183440000	domain	560000
chr4	4587	183440000	4591	183640000	boundary	200000
chr4	4592	183640000	4606	184240000	domain	600000
chr4	4607	184240000	4616	184640000	domain	400000
chr4	4617	184640000	4629	185160000	domain	520000
chr4	4630	185160000	4635	185400000	boundary	240000
chr4	4636	185400000	4640	185600000	boundary	200000
chr4	4641	185600000	4656	186240000	domain	640000
chr4	4657	186240000	4665	186600000	domain	360000
chr4	4666	186600000	4691	187640000	domain	1040000
chr4	4692	187640000	4740	189600000	domain	1960000
chr4	4741	189600000	4744	189760000	gap	160000
chr4	4745	189760000	4750	190000000	domain	240000
chr4	4751	190000000	4755	190200000	gap	200000
