chr	from.id	from.coord	to.id	to.coord	tag	size
chr13	1	16000000	73	18920000	gap	2920000
chr13	74	18920000	85	19400000	domain	480000
chr13	86	19400000	88	19520000	gap	120000
chr13	89	19520000	123	20920000	domain	1400000
chr13	124	20920000	140	21600000	domain	680000
chr13	141	21600000	173	22920000	domain	1320000
chr13	174	22920000	174	22960000	gap	40000
chr13	175	22960000	198	23920000	domain	960000
chr13	199	23920000	207	24280000	boundary	360000
chr13	208	24280000	214	24560000	boundary	280000
chr13	215	24560000	233	25320000	domain	760000
chr13	234	25320000	253	26120000	domain	800000
chr13	254	26120000	269	26760000	domain	640000
chr13	270	26760000	273	26920000	boundary	160000
chr13	274	26920000	300	28000000	domain	1080000
chr13	301	28000000	320	28800000	domain	800000
chr13	321	28800000	336	29440000	domain	640000
chr13	337	29440000	353	30120000	domain	680000
chr13	354	30120000	379	31160000	domain	1040000
chr13	380	31160000	396	31840000	domain	680000
chr13	397	31840000	408	32320000	domain	480000
chr13	409	32320000	414	32560000	boundary	240000
chr13	415	32560000	444	33760000	domain	1200000
chr13	445	33760000	479	35160000	domain	1400000
chr13	480	35160000	499	35960000	domain	800000
chr13	500	35960000	526	37040000	domain	1080000
chr13	527	37040000	541	37640000	domain	600000
chr13	542	37640000	574	38960000	domain	1320000
chr13	575	38960000	592	39680000	domain	720000
chr13	593	39680000	619	40760000	domain	1080000
chr13	620	40760000	626	41040000	boundary	280000
chr13	627	41040000	632	41280000	boundary	240000
chr13	633	41280000	657	42280000	domain	1000000
chr13	658	42280000	664	42560000	boundary	280000
chr13	665	42560000	697	43880000	domain	1320000
chr13	698	43880000	712	44480000	domain	600000
chr13	713	44480000	726	45040000	domain	560000
chr13	727	45040000	734	45360000	boundary	320000
chr13	735	45360000	737	45480000	boundary	120000
chr13	738	45480000	760	46400000	domain	920000
chr13	761	46400000	761	46440000	gap	40000
chr13	762	46440000	799	47960000	domain	1520000
chr13	800	47960000	820	48800000	domain	840000
chr13	821	48800000	824	48960000	boundary	160000
chr13	825	48960000	832	49280000	boundary	320000
chr13	833	49280000	841	49640000	boundary	360000
chr13	842	49640000	847	49880000	boundary	240000
chr13	848	49880000	878	51120000	domain	1240000
chr13	879	51120000	905	52200000	domain	1080000
chr13	906	52200000	908	52320000	gap	120000
chr13	909	52320000	912	52480000	domain	160000
chr13	913	52480000	915	52600000	gap	120000
chr13	916	52600000	930	53200000	domain	600000
chr13	931	53200000	997	55880000	domain	2680000
chr13	998	55880000	998	55920000	gap	40000
chr13	999	55920000	1028	57120000	domain	1200000
chr13	1029	57120000	1031	57240000	gap	120000
chr13	1032	57240000	1050	58000000	domain	760000
chr13	1051	58000000	1051	58040000	gap	40000
chr13	1052	58040000	1068	58720000	domain	680000
chr13	1069	58720000	1083	59320000	domain	600000
chr13	1084	59320000	1111	60440000	domain	1120000
chr13	1112	60440000	1116	60640000	boundary	200000
chr13	1117	60640000	1150	62000000	domain	1360000
chr13	1151	62000000	1159	62360000	boundary	360000
chr13	1160	62360000	1192	63680000	domain	1320000
chr13	1193	63680000	1196	63840000	gap	160000
chr13	1197	63840000	1211	64440000	domain	600000
chr13	1212	64440000	1241	65640000	domain	1200000
chr13	1242	65640000	1283	67320000	domain	1680000
chr13	1284	67320000	1307	68280000	domain	960000
chr13	1308	68280000	1337	69480000	domain	1200000
chr13	1338	69480000	1365	70600000	domain	1120000
chr13	1366	70600000	1373	70920000	domain	320000
chr13	1374	70920000	1419	72760000	domain	1840000
chr13	1420	72760000	1443	73720000	domain	960000
chr13	1444	73720000	1483	75320000	domain	1600000
chr13	1484	75320000	1489	75560000	boundary	240000
chr13	1490	75560000	1496	75840000	boundary	280000
chr13	1497	75840000	1524	76960000	domain	1120000
chr13	1525	76960000	1539	77560000	domain	600000
chr13	1540	77560000	1544	77760000	boundary	200000
chr13	1545	77760000	1554	78160000	domain	400000
chr13	1555	78160000	1585	79400000	domain	1240000
chr13	1586	79400000	1589	79560000	boundary	160000
chr13	1590	79560000	1610	80400000	domain	840000
chr13	1611	80400000	1625	81000000	domain	600000
chr13	1626	81000000	1644	81760000	domain	760000
chr13	1645	81760000	1647	81880000	boundary	120000
chr13	1648	81880000	1659	82360000	domain	480000
chr13	1660	82360000	1682	83280000	domain	920000
chr13	1683	83280000	1697	83880000	domain	600000
chr13	1698	83880000	1722	84880000	domain	1000000
chr13	1723	84880000	1755	86200000	domain	1320000
chr13	1756	86200000	1757	86280000	gap	80000
chr13	1758	86280000	1812	88480000	domain	2200000
chr13	1813	88480000	1813	88520000	gap	40000
chr13	1814	88520000	1843	89720000	domain	1200000
chr13	1844	89720000	1877	91080000	domain	1360000
chr13	1878	91080000	1882	91280000	boundary	200000
chr13	1883	91280000	1895	91800000	domain	520000
chr13	1896	91800000	1902	92080000	boundary	280000
chr13	1903	92080000	1960	94400000	domain	2320000
chr13	1961	94400000	1965	94600000	boundary	200000
chr13	1966	94600000	1987	95480000	domain	880000
chr13	1988	95480000	1997	95880000	boundary	400000
chr13	1998	95880000	2025	97000000	domain	1120000
chr13	2026	97000000	2046	97840000	domain	840000
chr13	2047	97840000	2070	98800000	domain	960000
chr13	2071	98800000	2078	99120000	boundary	320000
chr13	2079	99120000	2086	99440000	domain	320000
chr13	2087	99440000	2090	99600000	boundary	160000
chr13	2091	99600000	2114	100560000	domain	960000
chr13	2115	100560000	2129	101160000	domain	600000
chr13	2130	101160000	2164	102560000	domain	1400000
chr13	2165	102560000	2172	102880000	domain	320000
chr13	2173	102880000	2196	103840000	domain	960000
chr13	2197	103840000	2264	106560000	domain	2720000
chr13	2265	106560000	2279	107160000	domain	600000
chr13	2280	107160000	2305	108200000	domain	1040000
chr13	2306	108200000	2323	108920000	domain	720000
chr13	2324	108920000	2354	110160000	domain	1240000
chr13	2355	110160000	2361	110440000	boundary	280000
chr13	2362	110440000	2373	110920000	domain	480000
chr13	2374	110920000	2377	111080000	boundary	160000
chr13	2378	111080000	2392	111680000	domain	600000
chr13	2393	111680000	2396	111840000	gap	160000
chr13	2397	111840000	2407	112280000	domain	440000
chr13	2408	112280000	2407	112280000	gap	0
chr13	2408	112280000	2408	112320000	gap	40000
chr13	2409	112320000	2423	112920000	boundary	600000
chr13	2424	112920000	2429	113160000	boundary	240000
chr13	2430	113160000	2437	113480000	domain	320000
chr13	2438	113480000	2440	113600000	boundary	120000
chr13	2441	113600000	2443	113720000	domain	120000
chr13	2444	113720000	2456	114240000	domain	520000
chr13	2457	114240000	2459	114360000	domain	120000
