chr	from.id	from.coord	to.id	to.coord	tag	size
chr3	1	0	1	40000	gap	40000
chr3	2	40000	14	560000	domain	520000
chr3	15	560000	16	640000	gap	80000
chr3	17	640000	26	1040000	domain	400000
chr3	27	1040000	50	2000000	domain	960000
chr3	51	2000000	67	2680000	domain	680000
chr3	68	2680000	80	3200000	domain	520000
chr3	81	3200000	107	4280000	domain	1080000
chr3	108	4280000	117	4680000	domain	400000
chr3	118	4680000	131	5240000	domain	560000
chr3	132	5240000	155	6200000	domain	960000
chr3	156	6200000	170	6800000	domain	600000
chr3	171	6800000	189	7560000	domain	760000
chr3	190	7560000	210	8400000	domain	840000
chr3	211	8400000	217	8680000	domain	280000
chr3	218	8680000	224	8960000	domain	280000
chr3	225	8960000	233	9320000	domain	360000
chr3	234	9320000	243	9720000	domain	400000
chr3	244	9720000	258	10320000	domain	600000
chr3	259	10320000	269	10760000	domain	440000
chr3	270	10760000	277	11080000	domain	320000
chr3	278	11080000	284	11360000	domain	280000
chr3	285	11360000	297	11880000	domain	520000
chr3	298	11880000	303	12120000	domain	240000
chr3	304	12120000	312	12480000	domain	360000
chr3	313	12480000	321	12840000	domain	360000
chr3	322	12840000	325	13000000	domain	160000
chr3	326	13000000	337	13480000	domain	480000
chr3	338	13480000	342	13680000	domain	200000
chr3	343	13680000	353	14120000	domain	440000
chr3	354	14120000	364	14560000	domain	440000
chr3	365	14560000	378	15120000	domain	560000
chr3	379	15120000	379	15160000	gap	40000
chr3	380	15160000	390	15600000	domain	440000
chr3	391	15600000	395	15800000	domain	200000
chr3	396	15800000	407	16280000	domain	480000
chr3	408	16280000	415	16600000	domain	320000
chr3	416	16600000	431	17240000	domain	640000
chr3	432	17240000	447	17880000	domain	640000
chr3	448	17880000	471	18840000	domain	960000
chr3	472	18840000	476	19040000	domain	200000
chr3	477	19040000	490	19600000	domain	560000
chr3	491	19600000	497	19880000	domain	280000
chr3	498	19880000	506	20240000	domain	360000
chr3	507	20240000	508	20320000	boundary	80000
chr3	509	20320000	524	20960000	domain	640000
chr3	525	20960000	537	21480000	domain	520000
chr3	538	21480000	548	21920000	domain	440000
chr3	549	21920000	553	22120000	domain	200000
chr3	554	22120000	574	22960000	domain	840000
chr3	575	22960000	599	23960000	domain	1000000
chr3	600	23960000	607	24280000	domain	320000
chr3	608	24280000	617	24680000	domain	400000
chr3	618	24680000	640	25600000	domain	920000
chr3	641	25600000	682	27280000	domain	1680000
chr3	683	27280000	692	27680000	domain	400000
chr3	693	27680000	709	28360000	domain	680000
chr3	710	28360000	745	29800000	domain	1440000
chr3	746	29800000	769	30760000	domain	960000
chr3	770	30760000	788	31520000	domain	760000
chr3	789	31520000	804	32160000	domain	640000
chr3	805	32160000	812	32480000	domain	320000
chr3	813	32480000	817	32680000	domain	200000
chr3	818	32680000	824	32960000	domain	280000
chr3	825	32960000	828	33120000	domain	160000
chr3	829	33120000	835	33400000	domain	280000
chr3	836	33400000	846	33840000	domain	440000
chr3	847	33840000	867	34680000	domain	840000
chr3	868	34680000	893	35720000	domain	1040000
chr3	894	35720000	917	36680000	domain	960000
chr3	918	36680000	924	36960000	domain	280000
chr3	925	36960000	932	37280000	domain	320000
chr3	933	37280000	946	37840000	domain	560000
chr3	947	37840000	950	38000000	domain	160000
chr3	951	38000000	963	38520000	domain	520000
chr3	964	38520000	976	39040000	domain	520000
chr3	977	39040000	985	39400000	domain	360000
chr3	986	39400000	988	39520000	boundary	120000
chr3	989	39520000	1005	40200000	domain	680000
chr3	1006	40200000	1008	40320000	domain	120000
chr3	1009	40320000	1014	40560000	domain	240000
chr3	1015	40560000	1031	41240000	domain	680000
chr3	1032	41240000	1047	41880000	domain	640000
chr3	1048	41880000	1056	42240000	domain	360000
chr3	1057	42240000	1063	42520000	domain	280000
chr3	1064	42520000	1073	42920000	domain	400000
chr3	1074	42920000	1088	43520000	domain	600000
chr3	1089	43520000	1108	44320000	domain	800000
chr3	1109	44320000	1124	44960000	domain	640000
chr3	1125	44960000	1138	45520000	domain	560000
chr3	1139	45520000	1143	45720000	domain	200000
chr3	1144	45720000	1162	46480000	domain	760000
chr3	1163	46480000	1167	46680000	domain	200000
chr3	1168	46680000	1173	46920000	domain	240000
chr3	1174	46920000	1185	47400000	domain	480000
chr3	1186	47400000	1195	47800000	domain	400000
chr3	1196	47800000	1204	48160000	domain	360000
chr3	1205	48160000	1211	48440000	domain	280000
chr3	1212	48440000	1215	48600000	domain	160000
chr3	1216	48600000	1226	49040000	domain	440000
chr3	1227	49040000	1237	49480000	domain	440000
chr3	1238	49480000	1249	49960000	domain	480000
chr3	1250	49960000	1253	50120000	boundary	160000
chr3	1254	50120000	1259	50360000	domain	240000
chr3	1260	50360000	1266	50640000	domain	280000
chr3	1267	50640000	1284	51360000	domain	720000
chr3	1285	51360000	1298	51920000	domain	560000
chr3	1299	51920000	1304	52160000	domain	240000
chr3	1305	52160000	1310	52400000	domain	240000
chr3	1311	52400000	1318	52720000	domain	320000
chr3	1319	52720000	1327	53080000	domain	360000
chr3	1328	53080000	1332	53280000	domain	200000
chr3	1333	53280000	1348	53920000	domain	640000
chr3	1349	53920000	1361	54440000	domain	520000
chr3	1362	54440000	1370	54800000	domain	360000
chr3	1371	54800000	1380	55200000	domain	400000
chr3	1381	55200000	1387	55480000	domain	280000
chr3	1388	55480000	1408	56320000	domain	840000
chr3	1409	56320000	1414	56560000	domain	240000
chr3	1415	56560000	1425	57000000	domain	440000
chr3	1426	57000000	1431	57240000	domain	240000
chr3	1432	57240000	1447	57880000	domain	640000
chr3	1448	57880000	1454	58160000	domain	280000
chr3	1455	58160000	1457	58280000	boundary	120000
chr3	1458	58280000	1466	58640000	domain	360000
chr3	1467	58640000	1480	59200000	domain	560000
chr3	1481	59200000	1489	59560000	domain	360000
chr3	1490	59560000	1497	59880000	domain	320000
chr3	1498	59880000	1538	61520000	domain	1640000
chr3	1539	61520000	1555	62200000	domain	680000
chr3	1556	62200000	1565	62600000	domain	400000
chr3	1566	62600000	1582	63280000	domain	680000
chr3	1583	63280000	1596	63840000	domain	560000
chr3	1597	63840000	1600	64000000	domain	160000
chr3	1601	64000000	1613	64520000	domain	520000
chr3	1614	64520000	1635	65400000	domain	880000
chr3	1636	65400000	1644	65760000	domain	360000
chr3	1645	65760000	1656	66240000	domain	480000
chr3	1657	66240000	1671	66840000	domain	600000
chr3	1672	66840000	1685	67400000	domain	560000
chr3	1686	67400000	1722	68880000	domain	1480000
chr3	1723	68880000	1725	69000000	boundary	120000
chr3	1726	69000000	1742	69680000	domain	680000
chr3	1743	69680000	1750	70000000	domain	320000
chr3	1751	70000000	1761	70440000	domain	440000
chr3	1762	70440000	1763	70520000	boundary	80000
chr3	1764	70520000	1775	71000000	domain	480000
chr3	1776	71000000	1792	71680000	domain	680000
chr3	1793	71680000	1807	72280000	domain	600000
chr3	1808	72280000	1821	72840000	domain	560000
chr3	1822	72840000	1827	73080000	domain	240000
chr3	1828	73080000	1836	73440000	domain	360000
chr3	1837	73440000	1847	73880000	domain	440000
chr3	1848	73880000	1856	74240000	domain	360000
chr3	1857	74240000	1881	75240000	domain	1000000
chr3	1882	75240000	1882	75280000	gap	40000
chr3	1883	75280000	1888	75520000	domain	240000
chr3	1889	75520000	1899	75960000	gap	440000
chr3	1900	75960000	1916	76640000	domain	680000
chr3	1917	76640000	1933	77320000	domain	680000
chr3	1934	77320000	1966	78640000	domain	1320000
chr3	1967	78640000	1976	79040000	domain	400000
chr3	1977	79040000	1988	79520000	domain	480000
chr3	1989	79520000	2017	80680000	domain	1160000
chr3	2018	80680000	2032	81280000	domain	600000
chr3	2033	81280000	2055	82200000	domain	920000
chr3	2056	82200000	2076	83040000	domain	840000
chr3	2077	83040000	2090	83600000	domain	560000
chr3	2091	83600000	2092	83680000	boundary	80000
chr3	2093	83680000	2094	83760000	boundary	80000
chr3	2095	83760000	2100	84000000	boundary	240000
chr3	2101	84000000	2107	84280000	boundary	280000
chr3	2108	84280000	2111	84440000	boundary	160000
chr3	2112	84440000	2121	84840000	domain	400000
chr3	2122	84840000	2130	85200000	domain	360000
chr3	2131	85200000	2141	85640000	domain	440000
chr3	2142	85640000	2156	86240000	domain	600000
chr3	2157	86240000	2168	86720000	domain	480000
chr3	2169	86720000	2181	87240000	domain	520000
chr3	2182	87240000	2200	88000000	domain	760000
chr3	2201	88000000	2205	88200000	domain	200000
chr3	2206	88200000	2225	89000000	domain	800000
chr3	2226	89000000	2227	89080000	boundary	80000
chr3	2228	89080000	2256	90240000	domain	1160000
chr3	2257	90240000	2345	93800000	gap	3560000
chr3	2346	93800000	2356	94240000	domain	440000
chr3	2357	94240000	2369	94760000	domain	520000
chr3	2370	94760000	2407	96280000	domain	1520000
chr3	2408	96280000	2421	96840000	domain	560000
chr3	2422	96840000	2444	97760000	domain	920000
chr3	2445	97760000	2454	98160000	domain	400000
chr3	2455	98160000	2455	98200000	gap	40000
chr3	2456	98200000	2463	98520000	domain	320000
chr3	2464	98520000	2475	99000000	domain	480000
chr3	2476	99000000	2486	99440000	domain	440000
chr3	2487	99440000	2495	99800000	domain	360000
chr3	2496	99800000	2507	100280000	domain	480000
chr3	2508	100280000	2518	100720000	domain	440000
chr3	2519	100720000	2544	101760000	domain	1040000
chr3	2545	101760000	2556	102240000	domain	480000
chr3	2557	102240000	2564	102560000	domain	320000
chr3	2565	102560000	2580	103200000	domain	640000
chr3	2581	103200000	2581	103240000	gap	40000
chr3	2582	103240000	2602	104080000	domain	840000
chr3	2603	104080000	2614	104560000	domain	480000
chr3	2615	104560000	2634	105360000	domain	800000
chr3	2635	105360000	2641	105640000	domain	280000
chr3	2642	105640000	2665	106600000	domain	960000
chr3	2666	106600000	2680	107200000	domain	600000
chr3	2681	107200000	2689	107560000	domain	360000
chr3	2690	107560000	2698	107920000	domain	360000
chr3	2699	107920000	2712	108480000	domain	560000
chr3	2713	108480000	2714	108560000	boundary	80000
chr3	2715	108560000	2725	109000000	domain	440000
chr3	2726	109000000	2743	109720000	domain	720000
chr3	2744	109720000	2757	110280000	domain	560000
chr3	2758	110280000	2759	110360000	boundary	80000
chr3	2760	110360000	2777	111080000	domain	720000
chr3	2778	111080000	2789	111560000	domain	480000
chr3	2790	111560000	2802	112080000	domain	520000
chr3	2803	112080000	2814	112560000	domain	480000
chr3	2815	112560000	2825	113000000	domain	440000
chr3	2826	113000000	2833	113320000	domain	320000
chr3	2834	113320000	2844	113760000	domain	440000
chr3	2845	113760000	2849	113960000	domain	200000
chr3	2850	113960000	2852	114080000	domain	120000
chr3	2853	114080000	2859	114360000	domain	280000
chr3	2860	114360000	2869	114760000	domain	400000
chr3	2870	114760000	2880	115200000	domain	440000
chr3	2881	115200000	2896	115840000	domain	640000
chr3	2897	115840000	2919	116760000	domain	920000
chr3	2920	116760000	2925	117000000	domain	240000
chr3	2926	117000000	2951	118040000	domain	1040000
chr3	2952	118040000	2971	118840000	domain	800000
chr3	2972	118840000	2979	119160000	domain	320000
chr3	2980	119160000	2987	119480000	domain	320000
chr3	2988	119480000	2994	119760000	domain	280000
chr3	2995	119760000	3005	120200000	domain	440000
chr3	3006	120200000	3014	120560000	domain	360000
chr3	3015	120560000	3038	121520000	domain	960000
chr3	3039	121520000	3050	122000000	domain	480000
chr3	3051	122000000	3059	122360000	domain	360000
chr3	3060	122360000	3082	123280000	domain	920000
chr3	3083	123280000	3090	123600000	domain	320000
chr3	3091	123600000	3093	123720000	boundary	120000
chr3	3094	123720000	3100	124000000	domain	280000
chr3	3101	124000000	3119	124760000	domain	760000
chr3	3120	124760000	3142	125680000	domain	920000
chr3	3143	125680000	3149	125960000	gap	280000
chr3	3150	125960000	3162	126480000	domain	520000
chr3	3163	126480000	3176	127040000	domain	560000
chr3	3177	127040000	3189	127560000	domain	520000
chr3	3190	127560000	3201	128040000	domain	480000
chr3	3202	128040000	3215	128600000	domain	560000
chr3	3216	128600000	3222	128880000	domain	280000
chr3	3223	128880000	3234	129360000	domain	480000
chr3	3235	129360000	3236	129440000	boundary	80000
chr3	3237	129440000	3250	130000000	domain	560000
chr3	3251	130000000	3255	130200000	gap	200000
chr3	3256	130200000	3267	130680000	domain	480000
chr3	3268	130680000	3276	131040000	domain	360000
chr3	3277	131040000	3305	132200000	domain	1160000
chr3	3306	132200000	3310	132400000	domain	200000
chr3	3311	132400000	3318	132720000	domain	320000
chr3	3319	132720000	3335	133400000	domain	680000
chr3	3336	133400000	3341	133640000	domain	240000
chr3	3342	133640000	3348	133920000	domain	280000
chr3	3349	133920000	3355	134200000	domain	280000
chr3	3356	134200000	3363	134520000	domain	320000
chr3	3364	134520000	3398	135920000	domain	1400000
chr3	3399	135920000	3401	136040000	boundary	120000
chr3	3402	136040000	3419	136760000	domain	720000
chr3	3420	136760000	3426	137040000	domain	280000
chr3	3427	137040000	3441	137640000	domain	600000
chr3	3442	137640000	3451	138040000	domain	400000
chr3	3452	138040000	3464	138560000	domain	520000
chr3	3465	138560000	3473	138920000	domain	360000
chr3	3474	138920000	3484	139360000	domain	440000
chr3	3485	139360000	3522	140880000	domain	1520000
chr3	3523	140880000	3531	141240000	domain	360000
chr3	3532	141240000	3540	141600000	domain	360000
chr3	3541	141600000	3549	141960000	domain	360000
chr3	3550	141960000	3564	142560000	domain	600000
chr3	3565	142560000	3576	143040000	domain	480000
chr3	3577	143040000	3593	143720000	domain	680000
chr3	3594	143720000	3600	144000000	domain	280000
chr3	3601	144000000	3624	144960000	domain	960000
chr3	3625	144960000	3629	145160000	domain	200000
chr3	3630	145160000	3644	145760000	domain	600000
chr3	3645	145760000	3655	146200000	domain	440000
chr3	3656	146200000	3667	146680000	domain	480000
chr3	3668	146680000	3679	147160000	domain	480000
chr3	3680	147160000	3681	147240000	boundary	80000
chr3	3682	147240000	3692	147680000	domain	440000
chr3	3693	147680000	3702	148080000	domain	400000
chr3	3703	148080000	3709	148360000	domain	280000
chr3	3710	148360000	3719	148760000	domain	400000
chr3	3720	148760000	3724	148960000	domain	200000
chr3	3725	148960000	3733	149320000	domain	360000
chr3	3734	149320000	3746	149840000	domain	520000
chr3	3747	149840000	3755	150200000	domain	360000
chr3	3756	150200000	3763	150520000	domain	320000
chr3	3764	150520000	3779	151160000	domain	640000
chr3	3780	151160000	3786	151440000	domain	280000
chr3	3787	151440000	3798	151920000	domain	480000
chr3	3799	151920000	3812	152480000	domain	560000
chr3	3813	152480000	3825	153000000	domain	520000
chr3	3826	153000000	3850	154000000	domain	1000000
chr3	3851	154000000	3858	154320000	domain	320000
chr3	3859	154320000	3868	154720000	domain	400000
chr3	3869	154720000	3884	155360000	domain	640000
chr3	3885	155360000	3893	155720000	domain	360000
chr3	3894	155720000	3899	155960000	domain	240000
chr3	3900	155960000	3914	156560000	domain	600000
chr3	3915	156560000	3929	157160000	domain	600000
chr3	3930	157160000	3940	157600000	domain	440000
chr3	3941	157600000	3952	158080000	domain	480000
chr3	3953	158080000	3966	158640000	domain	560000
chr3	3967	158640000	3971	158840000	domain	200000
chr3	3972	158840000	3982	159280000	domain	440000
chr3	3983	159280000	3995	159800000	domain	520000
chr3	3996	159800000	3997	159880000	boundary	80000
chr3	3998	159880000	4000	160000000	domain	120000
chr3	4001	160000000	4012	160480000	domain	480000
chr3	4013	160480000	4024	160960000	domain	480000
chr3	4025	160960000	4037	161480000	domain	520000
chr3	4038	161480000	4062	162480000	domain	1000000
chr3	4063	162480000	4070	162800000	domain	320000
chr3	4071	162800000	4073	162920000	gap	120000
chr3	4074	162920000	4098	163920000	domain	1000000
chr3	4099	163920000	4130	165200000	domain	1280000
chr3	4131	165200000	4147	165880000	domain	680000
chr3	4148	165880000	4176	167040000	domain	1160000
chr3	4177	167040000	4185	167400000	domain	360000
chr3	4186	167400000	4193	167720000	domain	320000
chr3	4194	167720000	4205	168200000	domain	480000
chr3	4206	168200000	4221	168840000	domain	640000
chr3	4222	168840000	4228	169120000	domain	280000
chr3	4229	169120000	4244	169760000	domain	640000
chr3	4245	169760000	4257	170280000	domain	520000
chr3	4258	170280000	4260	170400000	domain	120000
chr3	4261	170400000	4272	170880000	domain	480000
chr3	4273	170880000	4290	171600000	domain	720000
chr3	4291	171600000	4309	172360000	domain	760000
chr3	4310	172360000	4319	172760000	domain	400000
chr3	4320	172760000	4339	173560000	domain	800000
chr3	4340	173560000	4411	176440000	domain	2880000
chr3	4412	176440000	4424	176960000	domain	520000
chr3	4425	176960000	4434	177360000	domain	400000
chr3	4435	177360000	4460	178400000	domain	1040000
chr3	4461	178400000	4475	179000000	domain	600000
chr3	4476	179000000	4484	179360000	domain	360000
chr3	4485	179360000	4490	179600000	domain	240000
chr3	4491	179600000	4516	180640000	domain	1040000
chr3	4517	180640000	4530	181200000	domain	560000
chr3	4531	181200000	4542	181680000	domain	480000
chr3	4543	181680000	4556	182240000	domain	560000
chr3	4557	182240000	4567	182680000	domain	440000
chr3	4568	182680000	4577	183080000	domain	400000
chr3	4578	183080000	4586	183440000	domain	360000
chr3	4587	183440000	4597	183880000	domain	440000
chr3	4598	183880000	4609	184360000	domain	480000
chr3	4610	184360000	4621	184840000	domain	480000
chr3	4622	184840000	4633	185320000	domain	480000
chr3	4634	185320000	4641	185640000	domain	320000
chr3	4642	185640000	4649	185960000	domain	320000
chr3	4650	185960000	4664	186560000	domain	600000
chr3	4665	186560000	4671	186840000	domain	280000
chr3	4672	186840000	4680	187200000	domain	360000
chr3	4681	187200000	4693	187720000	domain	520000
chr3	4694	187720000	4701	188040000	domain	320000
chr3	4702	188040000	4707	188280000	domain	240000
chr3	4708	188280000	4724	188960000	domain	680000
chr3	4725	188960000	4731	189240000	domain	280000
chr3	4732	189240000	4749	189960000	domain	720000
chr3	4750	189960000	4756	190240000	domain	280000
chr3	4757	190240000	4760	190400000	domain	160000
chr3	4761	190400000	4768	190720000	domain	320000
chr3	4769	190720000	4778	191120000	domain	400000
chr3	4779	191120000	4786	191440000	domain	320000
chr3	4787	191440000	4803	192120000	domain	680000
chr3	4804	192120000	4812	192480000	domain	360000
chr3	4813	192480000	4820	192800000	domain	320000
chr3	4821	192800000	4827	193080000	domain	280000
chr3	4828	193080000	4840	193600000	domain	520000
chr3	4841	193600000	4858	194320000	domain	720000
chr3	4859	194320000	4866	194640000	domain	320000
chr3	4867	194640000	4887	195480000	domain	840000
chr3	4888	195480000	4895	195800000	gap	320000
chr3	4896	195800000	4899	195960000	domain	160000
chr3	4900	195960000	4900	196000000	gap	40000
chr3	4901	196000000	4918	196720000	domain	720000
chr3	4919	196720000	4924	196960000	domain	240000
chr3	4925	196960000	4930	197200000	domain	240000
chr3	4931	197200000	4940	197600000	domain	400000
chr3	4941	197600000	4942	197680000	gap	80000
chr3	4943	197680000	4952	198080000	domain	400000
chr3	4953	198080000	4955	198200000	gap	120000
