chr	from.id	from.coord	to.id	to.coord	tag	size
chr3	1	0	1	40000	gap	40000
chr3	2	40000	14	560000	domain	520000
chr3	15	560000	16	640000	gap	80000
chr3	17	640000	79	3160000	domain	2520000
chr3	80	3160000	108	4320000	domain	1160000
chr3	109	4320000	116	4640000	boundary	320000
chr3	117	4640000	130	5200000	domain	560000
chr3	131	5200000	211	8440000	domain	3240000
chr3	212	8440000	217	8680000	boundary	240000
chr3	218	8680000	233	9320000	boundary	640000
chr3	234	9320000	258	10320000	domain	1000000
chr3	259	10320000	269	10760000	boundary	440000
chr3	270	10760000	273	10920000	boundary	160000
chr3	274	10920000	277	11080000	boundary	160000
chr3	278	11080000	314	12560000	domain	1480000
chr3	315	12560000	319	12760000	boundary	200000
chr3	320	12760000	325	13000000	boundary	240000
chr3	326	13000000	378	15120000	domain	2120000
chr3	379	15120000	379	15160000	gap	40000
chr3	380	15160000	414	16560000	domain	1400000
chr3	415	16560000	447	17880000	domain	1320000
chr3	448	17880000	475	19000000	domain	1120000
chr3	476	19000000	507	20280000	domain	1280000
chr3	508	20280000	554	22160000	domain	1880000
chr3	555	22160000	575	23000000	domain	840000
chr3	576	23000000	599	23960000	domain	960000
chr3	600	23960000	618	24720000	domain	760000
chr3	619	24720000	640	25600000	domain	880000
chr3	641	25600000	645	25800000	boundary	200000
chr3	646	25800000	678	27120000	domain	1320000
chr3	679	27120000	682	27280000	boundary	160000
chr3	683	27280000	710	28400000	domain	1120000
chr3	711	28400000	750	30000000	domain	1600000
chr3	751	30000000	788	31520000	domain	1520000
chr3	789	31520000	804	32160000	boundary	640000
chr3	805	32160000	812	32480000	boundary	320000
chr3	813	32480000	817	32680000	boundary	200000
chr3	818	32680000	828	33120000	boundary	440000
chr3	829	33120000	846	33840000	domain	720000
chr3	847	33840000	899	35960000	domain	2120000
chr3	900	35960000	918	36720000	domain	760000
chr3	919	36720000	925	37000000	boundary	280000
chr3	926	37000000	931	37240000	boundary	240000
chr3	932	37240000	946	37840000	boundary	600000
chr3	947	37840000	950	38000000	boundary	160000
chr3	951	38000000	963	38520000	boundary	520000
chr3	964	38520000	977	39080000	domain	560000
chr3	978	39080000	985	39400000	boundary	320000
chr3	986	39400000	1005	40200000	domain	800000
chr3	1006	40200000	1008	40320000	boundary	120000
chr3	1009	40320000	1056	42240000	domain	1920000
chr3	1057	42240000	1064	42560000	boundary	320000
chr3	1065	42560000	1072	42880000	boundary	320000
chr3	1073	42880000	1108	44320000	domain	1440000
chr3	1109	44320000	1124	44960000	boundary	640000
chr3	1125	44960000	1138	45520000	domain	560000
chr3	1139	45520000	1143	45720000	boundary	200000
chr3	1144	45720000	1162	46480000	domain	760000
chr3	1163	46480000	1167	46680000	boundary	200000
chr3	1168	46680000	1173	46920000	boundary	240000
chr3	1174	46920000	1184	47360000	boundary	440000
chr3	1185	47360000	1195	47800000	boundary	440000
chr3	1196	47800000	1205	48200000	boundary	400000
chr3	1206	48200000	1217	48680000	boundary	480000
chr3	1218	48680000	1225	49000000	boundary	320000
chr3	1226	49000000	1238	49520000	boundary	520000
chr3	1239	49520000	1258	50320000	boundary	800000
chr3	1259	50320000	1287	51480000	domain	1160000
chr3	1288	51480000	1298	51920000	boundary	440000
chr3	1299	51920000	1304	52160000	boundary	240000
chr3	1305	52160000	1310	52400000	boundary	240000
chr3	1311	52400000	1318	52720000	boundary	320000
chr3	1319	52720000	1327	53080000	boundary	360000
chr3	1328	53080000	1331	53240000	boundary	160000
chr3	1332	53240000	1348	53920000	boundary	680000
chr3	1349	53920000	1360	54400000	boundary	480000
chr3	1361	54400000	1413	56520000	domain	2120000
chr3	1414	56520000	1425	57000000	boundary	480000
chr3	1426	57000000	1458	58320000	domain	1320000
chr3	1459	58320000	1464	58560000	boundary	240000
chr3	1465	58560000	1466	58640000	boundary	80000
chr3	1467	58640000	1555	62200000	domain	3560000
chr3	1556	62200000	1558	62320000	boundary	120000
chr3	1559	62320000	1565	62600000	boundary	280000
chr3	1566	62600000	1596	63840000	domain	1240000
chr3	1597	63840000	1600	64000000	boundary	160000
chr3	1601	64000000	1612	64480000	boundary	480000
chr3	1613	64480000	1644	65760000	domain	1280000
chr3	1645	65760000	1655	66200000	boundary	440000
chr3	1656	66200000	1672	66880000	domain	680000
chr3	1673	66880000	1725	69000000	domain	2120000
chr3	1726	69000000	1750	70000000	domain	1000000
chr3	1751	70000000	1760	70400000	boundary	400000
chr3	1761	70400000	1792	71680000	domain	1280000
chr3	1793	71680000	1827	73080000	domain	1400000
chr3	1828	73080000	1837	73480000	boundary	400000
chr3	1838	73480000	1846	73840000	boundary	360000
chr3	1847	73840000	1888	75520000	domain	1680000
chr3	1889	75520000	1899	75960000	gap	440000
chr3	1900	75960000	1966	78640000	domain	2680000
chr3	1967	78640000	1977	79080000	domain	440000
chr3	1978	79080000	1988	79520000	boundary	440000
chr3	1989	79520000	2026	81040000	domain	1520000
chr3	2027	81040000	2027	81080000	gap	40000
chr3	2028	81080000	2091	83640000	domain	2560000
chr3	2092	83640000	2145	85800000	domain	2160000
chr3	2146	85800000	2166	86640000	domain	840000
chr3	2167	86640000	2180	87200000	boundary	560000
chr3	2181	87200000	2205	88200000	domain	1000000
chr3	2206	88200000	2256	90240000	domain	2040000
chr3	2257	90240000	2345	93800000	gap	3560000
chr3	2346	93800000	2421	96840000	domain	3040000
chr3	2422	96840000	2444	97760000	domain	920000
chr3	2445	97760000	2451	98040000	boundary	280000
chr3	2452	98040000	2459	98360000	boundary	320000
chr3	2460	98360000	2470	98800000	boundary	440000
chr3	2471	98800000	2475	99000000	boundary	200000
chr3	2476	99000000	2495	99800000	domain	800000
chr3	2496	99800000	2507	100280000	boundary	480000
chr3	2508	100280000	2542	101680000	domain	1400000
chr3	2543	101680000	2605	104200000	domain	2520000
chr3	2606	104200000	2612	104480000	boundary	280000
chr3	2613	104480000	2638	105520000	domain	1040000
chr3	2639	105520000	2680	107200000	domain	1680000
chr3	2681	107200000	2688	107520000	boundary	320000
chr3	2689	107520000	2716	108640000	domain	1120000
chr3	2717	108640000	2724	108960000	boundary	320000
chr3	2725	108960000	2791	111640000	domain	2680000
chr3	2792	111640000	2802	112080000	boundary	440000
chr3	2803	112080000	2814	112560000	domain	480000
chr3	2815	112560000	2825	113000000	domain	440000
chr3	2826	113000000	2837	113480000	domain	480000
chr3	2838	113480000	2849	113960000	boundary	480000
chr3	2850	113960000	2896	115840000	domain	1880000
chr3	2897	115840000	2919	116760000	domain	920000
chr3	2920	116760000	2972	118880000	domain	2120000
chr3	2973	118880000	2978	119120000	boundary	240000
chr3	2979	119120000	2993	119720000	boundary	600000
chr3	2994	119720000	3005	120200000	boundary	480000
chr3	3006	120200000	3014	120560000	boundary	360000
chr3	3015	120560000	3038	121520000	domain	960000
chr3	3039	121520000	3059	122360000	domain	840000
chr3	3060	122360000	3069	122760000	boundary	400000
chr3	3070	122760000	3083	123320000	domain	560000
chr3	3084	123320000	3090	123600000	boundary	280000
chr3	3091	123600000	3142	125680000	domain	2080000
chr3	3143	125680000	3149	125960000	gap	280000
chr3	3150	125960000	3189	127560000	domain	1600000
chr3	3190	127560000	3201	128040000	boundary	480000
chr3	3202	128040000	3216	128640000	boundary	600000
chr3	3217	128640000	3250	130000000	domain	1360000
chr3	3251	130000000	3255	130200000	gap	200000
chr3	3256	130200000	3311	132440000	domain	2240000
chr3	3312	132440000	3318	132720000	boundary	280000
chr3	3319	132720000	3363	134520000	domain	1800000
chr3	3364	134520000	3398	135920000	domain	1400000
chr3	3399	135920000	3426	137040000	domain	1120000
chr3	3427	137040000	3452	138080000	domain	1040000
chr3	3453	138080000	3485	139400000	domain	1320000
chr3	3486	139400000	3531	141240000	domain	1840000
chr3	3532	141240000	3549	141960000	domain	720000
chr3	3550	141960000	3563	142520000	boundary	560000
chr3	3564	142520000	3575	143000000	boundary	480000
chr3	3576	143000000	3593	143720000	domain	720000
chr3	3594	143720000	3631	145240000	domain	1520000
chr3	3632	145240000	3632	145280000	gap	40000
chr3	3633	145280000	3667	146680000	domain	1400000
chr3	3668	146680000	3724	148960000	domain	2280000
chr3	3725	148960000	3733	149320000	boundary	360000
chr3	3734	149320000	3746	149840000	boundary	520000
chr3	3747	149840000	3755	150200000	boundary	360000
chr3	3756	150200000	3763	150520000	boundary	320000
chr3	3764	150520000	3779	151160000	boundary	640000
chr3	3780	151160000	3824	152960000	domain	1800000
chr3	3825	152960000	3858	154320000	domain	1360000
chr3	3859	154320000	3895	155800000	domain	1480000
chr3	3896	155800000	3930	157200000	domain	1400000
chr3	3931	157200000	3938	157520000	boundary	320000
chr3	3939	157520000	3970	158800000	domain	1280000
chr3	3971	158800000	4013	160520000	domain	1720000
chr3	4014	160520000	4037	161480000	domain	960000
chr3	4038	161480000	4075	163000000	domain	1520000
chr3	4076	163000000	4076	163040000	gap	40000
chr3	4077	163040000	4133	165320000	domain	2280000
chr3	4134	165320000	4134	165360000	gap	40000
chr3	4135	165360000	4185	167400000	domain	2040000
chr3	4186	167400000	4223	168920000	domain	1520000
chr3	4224	168920000	4244	169760000	domain	840000
chr3	4245	169760000	4254	170160000	boundary	400000
chr3	4255	170160000	4272	170880000	domain	720000
chr3	4273	170880000	4319	172760000	domain	1880000
chr3	4320	172760000	4413	176520000	domain	3760000
chr3	4414	176520000	4421	176840000	boundary	320000
chr3	4422	176840000	4460	178400000	domain	1560000
chr3	4461	178400000	4475	179000000	boundary	600000
chr3	4476	179000000	4484	179360000	boundary	360000
chr3	4485	179360000	4490	179600000	boundary	240000
chr3	4491	179600000	4568	182720000	domain	3120000
chr3	4569	182720000	4585	183400000	boundary	680000
chr3	4586	183400000	4597	183880000	boundary	480000
chr3	4598	183880000	4609	184360000	boundary	480000
chr3	4610	184360000	4614	184560000	boundary	200000
chr3	4615	184560000	4621	184840000	boundary	280000
chr3	4622	184840000	4633	185320000	boundary	480000
chr3	4634	185320000	4641	185640000	boundary	320000
chr3	4642	185640000	4671	186840000	domain	1200000
chr3	4672	186840000	4680	187200000	domain	360000
chr3	4681	187200000	4693	187720000	boundary	520000
chr3	4694	187720000	4731	189240000	domain	1520000
chr3	4732	189240000	4749	189960000	domain	720000
chr3	4750	189960000	4762	190480000	boundary	520000
chr3	4763	190480000	4777	191080000	domain	600000
chr3	4778	191080000	4841	193640000	domain	2560000
chr3	4842	193640000	4887	195480000	domain	1840000
chr3	4888	195480000	4895	195800000	gap	320000
chr3	4896	195800000	4899	195960000	domain	160000
chr3	4900	195960000	4900	196000000	gap	40000
chr3	4901	196000000	4940	197600000	domain	1600000
chr3	4941	197600000	4942	197680000	gap	80000
chr3	4943	197680000	4953	198120000	domain	440000
chr3	4954	198120000	4955	198200000	gap	80000
