chr	from.id	from.coord	to.id	to.coord	tag	size
chr15	1	17000000	80	20200000	gap	3200000
chr15	81	20200000	86	20440000	domain	240000
chr15	87	20440000	145	22800000	gap	2360000
chr15	146	22800000	153	23120000	domain	320000
chr15	154	23120000	160	23400000	gap	280000
chr15	161	23400000	177	24080000	domain	680000
chr15	178	24080000	188	24520000	gap	440000
chr15	189	24520000	194	24760000	domain	240000
chr15	195	24760000	203	25120000	domain	360000
chr15	204	25120000	212	25480000	domain	360000
chr15	213	25480000	224	25960000	domain	480000
chr15	225	25960000	232	26280000	domain	320000
chr15	233	26280000	247	26880000	domain	600000
chr15	248	26880000	251	27040000	domain	160000
chr15	252	27040000	269	27760000	domain	720000
chr15	270	27760000	280	28200000	domain	440000
chr15	281	28200000	296	28840000	gap	640000
chr15	297	28840000	303	29120000	domain	280000
chr15	304	29120000	316	29640000	domain	520000
chr15	317	29640000	327	30080000	domain	440000
chr15	328	30080000	346	30840000	gap	760000
chr15	347	30840000	355	31200000	domain	360000
chr15	356	31200000	366	31640000	domain	440000
chr15	367	31640000	368	31720000	gap	80000
chr15	369	31720000	379	32160000	domain	440000
chr15	380	32160000	391	32640000	gap	480000
chr15	392	32640000	400	33000000	domain	360000
chr15	401	33000000	407	33280000	domain	280000
chr15	408	33280000	418	33720000	domain	440000
chr15	419	33720000	426	34040000	domain	320000
chr15	427	34040000	434	34360000	domain	320000
chr15	435	34360000	440	34600000	gap	240000
chr15	441	34600000	450	35000000	domain	400000
chr15	451	35000000	463	35520000	domain	520000
chr15	464	35520000	469	35760000	domain	240000
chr15	470	35760000	487	36480000	domain	720000
chr15	488	36480000	497	36880000	domain	400000
chr15	498	36880000	504	37160000	domain	280000
chr15	505	37160000	512	37480000	domain	320000
chr15	513	37480000	524	37960000	domain	480000
chr15	525	37960000	535	38400000	domain	440000
chr15	536	38400000	543	38720000	domain	320000
chr15	544	38720000	554	39160000	domain	440000
chr15	555	39160000	565	39600000	domain	440000
chr15	566	39600000	576	40040000	domain	440000
chr15	577	40040000	583	40320000	domain	280000
chr15	584	40320000	586	40440000	domain	120000
chr15	587	40440000	588	40520000	boundary	80000
chr15	589	40520000	597	40880000	domain	360000
chr15	598	40880000	609	41360000	domain	480000
chr15	610	41360000	624	41960000	domain	600000
chr15	625	41960000	629	42160000	domain	200000
chr15	630	42160000	637	42480000	domain	320000
chr15	638	42480000	642	42680000	domain	200000
chr15	643	42680000	649	42960000	domain	280000
chr15	650	42960000	664	43560000	domain	600000
chr15	665	43560000	668	43720000	gap	160000
chr15	669	43720000	688	44520000	domain	800000
chr15	689	44520000	695	44800000	domain	280000
chr15	696	44800000	696	44840000	gap	40000
chr15	697	44840000	701	45040000	domain	200000
chr15	702	45040000	702	45080000	gap	40000
chr15	703	45080000	710	45400000	domain	320000
chr15	711	45400000	717	45680000	domain	280000
chr15	718	45680000	732	46280000	domain	600000
chr15	733	46280000	754	47160000	domain	880000
chr15	755	47160000	775	48000000	domain	840000
chr15	776	48000000	783	48320000	domain	320000
chr15	784	48320000	796	48840000	domain	520000
chr15	797	48840000	805	49200000	domain	360000
chr15	806	49200000	827	50080000	domain	880000
chr15	828	50080000	834	50360000	domain	280000
chr15	835	50360000	848	50920000	domain	560000
chr15	849	50920000	862	51480000	domain	560000
chr15	863	51480000	872	51880000	domain	400000
chr15	873	51880000	881	52240000	domain	360000
chr15	882	52240000	894	52760000	domain	520000
chr15	895	52760000	906	53240000	domain	480000
chr15	907	53240000	918	53720000	domain	480000
chr15	919	53720000	944	54760000	domain	1040000
chr15	945	54760000	954	55160000	domain	400000
chr15	955	55160000	962	55480000	domain	320000
chr15	963	55480000	972	55880000	domain	400000
chr15	973	55880000	987	56480000	domain	600000
chr15	988	56480000	997	56880000	domain	400000
chr15	998	56880000	1008	57320000	domain	440000
chr15	1009	57320000	1014	57560000	domain	240000
chr15	1015	57560000	1030	58200000	domain	640000
chr15	1031	58200000	1049	58960000	domain	760000
chr15	1050	58960000	1063	59520000	domain	560000
chr15	1064	59520000	1067	59680000	domain	160000
chr15	1068	59680000	1083	60320000	domain	640000
chr15	1084	60320000	1088	60520000	domain	200000
chr15	1089	60520000	1103	61120000	domain	600000
chr15	1104	61120000	1121	61840000	domain	720000
chr15	1122	61840000	1126	62040000	domain	200000
chr15	1127	62040000	1133	62320000	domain	280000
chr15	1134	62320000	1143	62720000	domain	400000
chr15	1144	62720000	1153	63120000	domain	400000
chr15	1154	63120000	1166	63640000	domain	520000
chr15	1167	63640000	1179	64160000	domain	520000
chr15	1180	64160000	1185	64400000	domain	240000
chr15	1186	64400000	1192	64680000	domain	280000
chr15	1193	64680000	1200	65000000	domain	320000
chr15	1201	65000000	1207	65280000	domain	280000
chr15	1208	65280000	1223	65920000	domain	640000
chr15	1224	65920000	1231	66240000	domain	320000
chr15	1232	66240000	1239	66560000	domain	320000
chr15	1240	66560000	1247	66880000	domain	320000
chr15	1248	66880000	1258	67320000	domain	440000
chr15	1259	67320000	1271	67840000	domain	520000
chr15	1272	67840000	1281	68240000	domain	400000
chr15	1282	68240000	1300	69000000	domain	760000
chr15	1301	69000000	1311	69440000	domain	440000
chr15	1312	69440000	1327	70080000	domain	640000
chr15	1328	70080000	1338	70520000	domain	440000
chr15	1339	70520000	1347	70880000	domain	360000
chr15	1348	70880000	1361	71440000	domain	560000
chr15	1362	71440000	1370	71800000	domain	360000
chr15	1371	71800000	1380	72200000	domain	400000
chr15	1381	72200000	1391	72640000	domain	440000
chr15	1392	72640000	1392	72680000	gap	40000
chr15	1393	72680000	1407	73280000	domain	600000
chr15	1408	73280000	1413	73520000	domain	240000
chr15	1414	73520000	1426	74040000	domain	520000
chr15	1427	74040000	1428	74120000	gap	80000
chr15	1429	74120000	1434	74360000	domain	240000
chr15	1435	74360000	1440	74600000	domain	240000
chr15	1441	74600000	1450	75000000	domain	400000
chr15	1451	75000000	1456	75240000	domain	240000
chr15	1457	75240000	1458	75320000	gap	80000
chr15	1459	75320000	1471	75840000	domain	520000
chr15	1472	75840000	1479	76160000	domain	320000
chr15	1480	76160000	1497	76880000	domain	720000
chr15	1498	76880000	1503	77120000	domain	240000
chr15	1504	77120000	1514	77560000	domain	440000
chr15	1515	77560000	1522	77880000	domain	320000
chr15	1523	77880000	1524	77960000	gap	80000
chr15	1525	77960000	1532	78280000	domain	320000
chr15	1533	78280000	1543	78720000	domain	440000
chr15	1544	78720000	1544	78760000	gap	40000
chr15	1545	78760000	1550	79000000	domain	240000
chr15	1551	79000000	1557	79280000	domain	280000
chr15	1558	79280000	1585	80400000	domain	1120000
chr15	1586	80400000	1600	81000000	domain	600000
chr15	1601	81000000	1611	81440000	domain	440000
chr15	1612	81440000	1617	81680000	domain	240000
chr15	1618	81680000	1618	81720000	gap	40000
chr15	1619	81720000	1630	82200000	domain	480000
chr15	1631	82200000	1638	82520000	gap	320000
chr15	1639	82520000	1644	82760000	domain	240000
chr15	1645	82760000	1656	83240000	domain	480000
chr15	1657	83240000	1678	84120000	domain	880000
chr15	1679	84120000	1689	84560000	gap	440000
chr15	1690	84560000	1698	84920000	domain	360000
chr15	1699	84920000	1704	85160000	domain	240000
chr15	1705	85160000	1707	85280000	gap	120000
chr15	1708	85280000	1721	85840000	domain	560000
chr15	1722	85840000	1731	86240000	domain	400000
chr15	1732	86240000	1781	88240000	domain	2000000
chr15	1782	88240000	1787	88480000	domain	240000
chr15	1788	88480000	1798	88920000	domain	440000
chr15	1799	88920000	1808	89320000	domain	400000
chr15	1809	89320000	1815	89600000	domain	280000
chr15	1816	89600000	1822	89880000	domain	280000
chr15	1823	89880000	1828	90120000	domain	240000
chr15	1829	90120000	1832	90280000	boundary	160000
chr15	1833	90280000	1841	90640000	domain	360000
chr15	1842	90640000	1848	90920000	domain	280000
chr15	1849	90920000	1858	91320000	domain	400000
chr15	1859	91320000	1877	92080000	domain	760000
chr15	1878	92080000	1887	92480000	domain	400000
chr15	1888	92480000	1894	92760000	domain	280000
chr15	1895	92760000	1901	93040000	domain	280000
chr15	1902	93040000	1929	94160000	domain	1120000
chr15	1930	94160000	1934	94360000	domain	200000
chr15	1935	94360000	1941	94640000	domain	280000
chr15	1942	94640000	1949	94960000	domain	320000
chr15	1950	94960000	1956	95240000	domain	280000
chr15	1957	95240000	1984	96360000	domain	1120000
chr15	1985	96360000	1997	96880000	domain	520000
chr15	1998	96880000	2007	97280000	domain	400000
chr15	2008	97280000	2022	97880000	domain	600000
chr15	2023	97880000	2030	98200000	domain	320000
chr15	2031	98200000	2036	98440000	domain	240000
chr15	2037	98440000	2052	99080000	domain	640000
chr15	2053	99080000	2056	99240000	domain	160000
chr15	2057	99240000	2069	99760000	domain	520000
chr15	2070	99760000	2071	99840000	gap	80000
chr15	2072	99840000	2083	100320000	domain	480000
chr15	2084	100320000	2090	100600000	domain	280000
chr15	2091	100600000	2098	100920000	domain	320000
chr15	2099	100920000	2107	101280000	domain	360000
chr15	2108	101280000	2118	101720000	domain	440000
chr15	2119	101720000	2125	101991189	gap	271189
