chr	from.id	from.coord	to.id	to.coord	tag	size
chr16	1	0	1	40000	gap	40000
chr16	2	40000	14	560000	domain	520000
chr16	15	560000	15	600000	gap	40000
chr16	16	600000	30	1200000	domain	600000
chr16	31	1200000	31	1240000	gap	40000
chr16	32	1240000	52	2080000	domain	840000
chr16	53	2080000	54	2160000	gap	80000
chr16	55	2160000	63	2520000	domain	360000
chr16	64	2520000	68	2720000	gap	200000
chr16	69	2720000	75	3000000	domain	280000
chr16	76	3000000	79	3160000	boundary	160000
chr16	80	3160000	88	3520000	domain	360000
chr16	89	3520000	98	3920000	domain	400000
chr16	99	3920000	111	4440000	domain	520000
chr16	112	4440000	127	5080000	domain	640000
chr16	128	5080000	132	5280000	gap	200000
chr16	133	5280000	142	5680000	domain	400000
chr16	143	5680000	149	5960000	domain	280000
chr16	150	5960000	167	6680000	domain	720000
chr16	168	6680000	174	6960000	domain	280000
chr16	175	6960000	183	7320000	domain	360000
chr16	184	7320000	195	7800000	domain	480000
chr16	196	7800000	206	8240000	domain	440000
chr16	207	8240000	214	8560000	domain	320000
chr16	215	8560000	222	8880000	domain	320000
chr16	223	8880000	229	9160000	domain	280000
chr16	230	9160000	256	10240000	domain	1080000
chr16	257	10240000	267	10680000	domain	440000
chr16	268	10680000	268	10720000	gap	40000
chr16	269	10720000	274	10960000	domain	240000
chr16	275	10960000	284	11360000	domain	400000
chr16	285	11360000	298	11920000	domain	560000
chr16	299	11920000	299	11960000	gap	40000
chr16	300	11960000	323	12920000	domain	960000
chr16	324	12920000	346	13840000	domain	920000
chr16	347	13840000	357	14280000	domain	440000
chr16	358	14280000	367	14680000	domain	400000
chr16	368	14680000	385	15400000	gap	720000
chr16	386	15400000	394	15760000	domain	360000
chr16	395	15760000	405	16200000	domain	440000
chr16	406	16200000	419	16760000	gap	560000
chr16	420	16760000	437	17480000	domain	720000
chr16	438	17480000	452	18080000	domain	600000
chr16	453	18080000	473	18920000	gap	840000
chr16	474	18920000	494	19760000	domain	840000
chr16	495	19760000	495	19800000	gap	40000
chr16	496	19800000	511	20440000	domain	640000
chr16	512	20440000	515	20600000	gap	160000
chr16	516	20600000	533	21320000	domain	720000
chr16	534	21320000	538	21520000	gap	200000
chr16	539	21520000	543	21720000	domain	200000
chr16	544	21720000	549	21960000	gap	240000
chr16	550	21960000	555	22200000	domain	240000
chr16	556	22200000	561	22440000	domain	240000
chr16	562	22440000	565	22600000	gap	160000
chr16	566	22600000	579	23160000	domain	560000
chr16	580	23160000	592	23680000	domain	520000
chr16	593	23680000	601	24040000	domain	360000
chr16	602	24040000	613	24520000	domain	480000
chr16	614	24520000	621	24840000	domain	320000
chr16	622	24840000	632	25280000	domain	440000
chr16	633	25280000	642	25680000	domain	400000
chr16	643	25680000	645	25800000	domain	120000
chr16	646	25800000	678	27120000	domain	1320000
chr16	679	27120000	687	27480000	domain	360000
chr16	688	27480000	708	28320000	domain	840000
chr16	709	28320000	720	28800000	gap	480000
chr16	721	28800000	726	29040000	domain	240000
chr16	727	29040000	741	29640000	gap	600000
chr16	742	29640000	754	30160000	domain	520000
chr16	755	30160000	759	30360000	gap	200000
chr16	760	30360000	767	30680000	domain	320000
chr16	768	30680000	774	30960000	domain	280000
chr16	775	30960000	780	31200000	domain	240000
chr16	781	31200000	790	31600000	domain	400000
chr16	791	31600000	791	31640000	gap	40000
chr16	792	31640000	798	31920000	domain	280000
chr16	799	31920000	881	35240000	gap	3320000
chr16	882	35240000	888	35520000	domain	280000
chr16	889	35520000	1162	46480000	gap	10960000
chr16	1163	46480000	1170	46800000	domain	320000
chr16	1171	46800000	1179	47160000	domain	360000
chr16	1180	47160000	1180	47200000	gap	40000
chr16	1181	47200000	1204	48160000	domain	960000
chr16	1205	48160000	1216	48640000	domain	480000
chr16	1217	48640000	1234	49360000	domain	720000
chr16	1235	49360000	1250	50000000	domain	640000
chr16	1251	50000000	1259	50360000	domain	360000
chr16	1260	50360000	1271	50840000	domain	480000
chr16	1272	50840000	1295	51800000	domain	960000
chr16	1296	51800000	1301	52040000	domain	240000
chr16	1302	52040000	1326	53040000	domain	1000000
chr16	1327	53040000	1338	53520000	domain	480000
chr16	1339	53520000	1357	54280000	domain	760000
chr16	1358	54280000	1374	54960000	domain	680000
chr16	1375	54960000	1386	55440000	domain	480000
chr16	1387	55440000	1394	55760000	domain	320000
chr16	1395	55760000	1396	55840000	gap	80000
chr16	1397	55840000	1410	56400000	domain	560000
chr16	1411	56400000	1418	56720000	domain	320000
chr16	1419	56720000	1421	56840000	domain	120000
chr16	1422	56840000	1431	57240000	domain	400000
chr16	1432	57240000	1438	57520000	domain	280000
chr16	1439	57520000	1450	58000000	domain	480000
chr16	1451	58000000	1463	58520000	domain	520000
chr16	1464	58520000	1469	58760000	domain	240000
chr16	1470	58760000	1507	60280000	domain	1520000
chr16	1508	60280000	1512	60480000	domain	200000
chr16	1513	60480000	1521	60840000	domain	360000
chr16	1522	60840000	1532	61280000	domain	440000
chr16	1533	61280000	1543	61720000	domain	440000
chr16	1544	61720000	1554	62160000	domain	440000
chr16	1555	62160000	1566	62640000	domain	480000
chr16	1567	62640000	1584	63360000	domain	720000
chr16	1585	63360000	1628	65120000	domain	1760000
chr16	1629	65120000	1659	66360000	domain	1240000
chr16	1660	66360000	1672	66880000	domain	520000
chr16	1673	66880000	1681	67240000	domain	360000
chr16	1682	67240000	1687	67480000	domain	240000
chr16	1688	67480000	1706	68240000	domain	760000
chr16	1707	68240000	1713	68520000	domain	280000
chr16	1714	68520000	1728	69120000	domain	600000
chr16	1729	69120000	1734	69360000	domain	240000
chr16	1735	69360000	1748	69920000	domain	560000
chr16	1749	69920000	1756	70240000	gap	320000
chr16	1757	70240000	1770	70800000	domain	560000
chr16	1771	70800000	1779	71160000	gap	360000
chr16	1780	71160000	1785	71400000	domain	240000
chr16	1786	71400000	1791	71640000	domain	240000
chr16	1792	71640000	1802	72080000	domain	440000
chr16	1803	72080000	1812	72480000	domain	400000
chr16	1813	72480000	1830	73200000	domain	720000
chr16	1831	73200000	1849	73960000	domain	760000
chr16	1850	73960000	1858	74320000	domain	360000
chr16	1859	74320000	1864	74560000	gap	240000
chr16	1865	74560000	1873	74920000	domain	360000
chr16	1874	74920000	1879	75160000	domain	240000
chr16	1880	75160000	1886	75440000	domain	280000
chr16	1887	75440000	1895	75800000	domain	360000
chr16	1896	75800000	1917	76680000	domain	880000
chr16	1918	76680000	1930	77200000	domain	520000
chr16	1931	77200000	1940	77600000	domain	400000
chr16	1941	77600000	1952	78080000	domain	480000
chr16	1953	78080000	1990	79600000	domain	1520000
chr16	1991	79600000	2012	80480000	domain	880000
chr16	2013	80480000	2021	80840000	domain	360000
chr16	2022	80840000	2026	81040000	domain	200000
chr16	2027	81040000	2034	81360000	domain	320000
chr16	2035	81360000	2044	81760000	domain	400000
chr16	2045	81760000	2056	82240000	domain	480000
chr16	2057	82240000	2067	82680000	domain	440000
chr16	2068	82680000	2078	83120000	domain	440000
chr16	2079	83120000	2086	83440000	domain	320000
chr16	2087	83440000	2098	83920000	domain	480000
chr16	2099	83920000	2105	84200000	domain	280000
chr16	2106	84200000	2112	84480000	domain	280000
chr16	2113	84480000	2118	84720000	domain	240000
chr16	2119	84720000	2128	85120000	domain	400000
chr16	2129	85120000	2131	85240000	domain	120000
chr16	2132	85240000	2145	85800000	domain	560000
chr16	2146	85800000	2152	86080000	domain	280000
chr16	2153	86080000	2164	86560000	domain	480000
chr16	2165	86560000	2182	87280000	domain	720000
chr16	2183	87280000	2194	87760000	domain	480000
chr16	2195	87760000	2200	88000000	domain	240000
chr16	2201	88000000	2207	88280000	gap	280000
chr16	2208	88280000	2214	88560000	domain	280000
chr16	2215	88560000	2229	89160000	domain	600000
chr16	2230	89160000	2230	89200000	gap	40000
chr16	2231	89200000	2242	89680000	domain	480000
chr16	2243	89680000	2252	90080000	domain	400000
chr16	2253	90080000	2256	90240000	gap	160000
