chr	from.id	from.coord	to.id	to.coord	tag	size
chr4	1	0	2	80000	gap	80000
chr4	3	80000	13	520000	domain	440000
chr4	14	520000	16	640000	domain	120000
chr4	17	640000	26	1040000	domain	400000
chr4	27	1040000	34	1360000	domain	320000
chr4	35	1360000	42	1680000	domain	320000
chr4	43	1680000	48	1920000	domain	240000
chr4	49	1920000	55	2200000	domain	280000
chr4	56	2200000	62	2480000	domain	280000
chr4	63	2480000	68	2720000	domain	240000
chr4	69	2720000	77	3080000	domain	360000
chr4	78	3080000	89	3560000	domain	480000
chr4	90	3560000	90	3600000	gap	40000
chr4	91	3600000	98	3920000	domain	320000
chr4	99	3920000	105	4200000	gap	280000
chr4	106	4200000	111	4440000	domain	240000
chr4	112	4440000	137	5480000	domain	1040000
chr4	138	5480000	146	5840000	domain	360000
chr4	147	5840000	155	6200000	domain	360000
chr4	156	6200000	166	6640000	domain	440000
chr4	167	6640000	172	6880000	domain	240000
chr4	173	6880000	177	7080000	domain	200000
chr4	178	7080000	185	7400000	domain	320000
chr4	186	7400000	193	7720000	domain	320000
chr4	194	7720000	201	8040000	domain	320000
chr4	202	8040000	204	8160000	domain	120000
chr4	205	8160000	211	8440000	domain	280000
chr4	212	8440000	216	8640000	domain	200000
chr4	217	8640000	224	8960000	domain	320000
chr4	225	8960000	244	9760000	gap	800000
chr4	245	9760000	253	10120000	domain	360000
chr4	254	10120000	264	10560000	domain	440000
chr4	265	10560000	286	11440000	domain	880000
chr4	287	11440000	293	11720000	domain	280000
chr4	294	11720000	300	12000000	domain	280000
chr4	301	12000000	307	12280000	domain	280000
chr4	308	12280000	318	12720000	domain	440000
chr4	319	12720000	339	13560000	domain	840000
chr4	340	13560000	341	13640000	boundary	80000
chr4	342	13640000	354	14160000	domain	520000
chr4	355	14160000	369	14760000	domain	600000
chr4	370	14760000	380	15200000	domain	440000
chr4	381	15200000	387	15480000	domain	280000
chr4	388	15480000	391	15640000	domain	160000
chr4	392	15640000	400	16000000	domain	360000
chr4	401	16000000	407	16280000	domain	280000
chr4	408	16280000	413	16520000	domain	240000
chr4	414	16520000	437	17480000	domain	960000
chr4	438	17480000	446	17840000	domain	360000
chr4	447	17840000	466	18640000	domain	800000
chr4	467	18640000	480	19200000	domain	560000
chr4	481	19200000	506	20240000	domain	1040000
chr4	507	20240000	518	20720000	domain	480000
chr4	519	20720000	529	21160000	domain	440000
chr4	530	21160000	537	21480000	domain	320000
chr4	538	21480000	545	21800000	domain	320000
chr4	546	21800000	560	22400000	domain	600000
chr4	561	22400000	568	22720000	domain	320000
chr4	569	22720000	575	23000000	domain	280000
chr4	576	23000000	593	23720000	domain	720000
chr4	594	23720000	611	24440000	domain	720000
chr4	612	24440000	629	25160000	domain	720000
chr4	630	25160000	635	25400000	domain	240000
chr4	636	25400000	649	25960000	domain	560000
chr4	650	25960000	658	26320000	domain	360000
chr4	659	26320000	661	26440000	domain	120000
chr4	662	26440000	676	27040000	domain	600000
chr4	677	27040000	692	27680000	domain	640000
chr4	693	27680000	696	27840000	domain	160000
chr4	697	27840000	722	28880000	domain	1040000
chr4	723	28880000	727	29080000	domain	200000
chr4	728	29080000	744	29760000	domain	680000
chr4	745	29760000	748	29920000	domain	160000
chr4	749	29920000	758	30320000	domain	400000
chr4	759	30320000	767	30680000	domain	360000
chr4	768	30680000	776	31040000	domain	360000
chr4	777	31040000	784	31360000	domain	320000
chr4	785	31360000	795	31800000	domain	440000
chr4	796	31800000	796	31840000	gap	40000
chr4	797	31840000	811	32440000	domain	600000
chr4	812	32440000	826	33040000	domain	600000
chr4	827	33040000	853	34120000	domain	1080000
chr4	854	34120000	869	34760000	domain	640000
chr4	870	34760000	871	34840000	gap	80000
chr4	872	34840000	879	35160000	domain	320000
chr4	880	35160000	886	35440000	domain	280000
chr4	887	35440000	906	36240000	domain	800000
chr4	907	36240000	909	36360000	domain	120000
chr4	910	36360000	935	37400000	domain	1040000
chr4	936	37400000	940	37600000	domain	200000
chr4	941	37600000	945	37800000	domain	200000
chr4	946	37800000	951	38040000	domain	240000
chr4	952	38040000	968	38720000	domain	680000
chr4	969	38720000	979	39160000	domain	440000
chr4	980	39160000	986	39440000	domain	280000
chr4	987	39440000	992	39680000	domain	240000
chr4	993	39680000	1000	40000000	domain	320000
chr4	1001	40000000	1009	40360000	domain	360000
chr4	1010	40360000	1018	40720000	domain	360000
chr4	1019	40720000	1023	40920000	domain	200000
chr4	1024	40920000	1031	41240000	domain	320000
chr4	1032	41240000	1042	41680000	domain	440000
chr4	1043	41680000	1048	41920000	domain	240000
chr4	1049	41920000	1057	42280000	domain	360000
chr4	1058	42280000	1064	42560000	domain	280000
chr4	1065	42560000	1072	42880000	domain	320000
chr4	1073	42880000	1075	43000000	domain	120000
chr4	1076	43000000	1098	43920000	domain	920000
chr4	1099	43920000	1111	44440000	domain	520000
chr4	1112	44440000	1116	44640000	domain	200000
chr4	1117	44640000	1138	45520000	domain	880000
chr4	1139	45520000	1145	45800000	domain	280000
chr4	1146	45800000	1154	46160000	domain	360000
chr4	1155	46160000	1158	46320000	domain	160000
chr4	1159	46320000	1166	46640000	domain	320000
chr4	1167	46640000	1170	46800000	domain	160000
chr4	1171	46800000	1183	47320000	domain	520000
chr4	1184	47320000	1186	47440000	domain	120000
chr4	1187	47440000	1191	47640000	domain	200000
chr4	1192	47640000	1197	47880000	domain	240000
chr4	1198	47880000	1204	48160000	domain	280000
chr4	1205	48160000	1207	48280000	domain	120000
chr4	1208	48280000	1214	48560000	domain	280000
chr4	1215	48560000	1227	49080000	domain	520000
chr4	1228	49080000	1296	51840000	gap	2760000
chr4	1297	51840000	1306	52240000	domain	400000
chr4	1307	52240000	1314	52560000	domain	320000
chr4	1315	52560000	1325	53000000	domain	440000
chr4	1326	53000000	1336	53440000	domain	440000
chr4	1337	53440000	1348	53920000	domain	480000
chr4	1349	53920000	1357	54280000	domain	360000
chr4	1358	54280000	1366	54640000	domain	360000
chr4	1367	54640000	1374	54960000	domain	320000
chr4	1375	54960000	1383	55320000	domain	360000
chr4	1384	55320000	1389	55560000	domain	240000
chr4	1390	55560000	1396	55840000	domain	280000
chr4	1397	55840000	1409	56360000	domain	520000
chr4	1410	56360000	1414	56560000	domain	200000
chr4	1415	56560000	1422	56880000	domain	320000
chr4	1423	56880000	1426	57040000	domain	160000
chr4	1427	57040000	1435	57400000	domain	360000
chr4	1436	57400000	1463	58520000	domain	1120000
chr4	1464	58520000	1472	58880000	domain	360000
chr4	1473	58880000	1473	58920000	gap	40000
chr4	1474	58920000	1484	59360000	domain	440000
chr4	1485	59360000	1492	59680000	domain	320000
chr4	1493	59680000	1502	60080000	domain	400000
chr4	1503	60080000	1506	60240000	domain	160000
chr4	1507	60240000	1508	60320000	boundary	80000
chr4	1509	60320000	1513	60520000	domain	200000
chr4	1514	60520000	1519	60760000	domain	240000
chr4	1520	60760000	1569	62760000	domain	2000000
chr4	1570	62760000	1576	63040000	domain	280000
chr4	1577	63040000	1580	63200000	domain	160000
chr4	1581	63200000	1585	63400000	domain	200000
chr4	1586	63400000	1594	63760000	domain	360000
chr4	1595	63760000	1604	64160000	domain	400000
chr4	1605	64160000	1614	64560000	domain	400000
chr4	1615	64560000	1626	65040000	domain	480000
chr4	1627	65040000	1639	65560000	domain	520000
chr4	1640	65560000	1669	66760000	domain	1200000
chr4	1670	66760000	1685	67400000	domain	640000
chr4	1686	67400000	1706	68240000	domain	840000
chr4	1707	68240000	1713	68520000	domain	280000
chr4	1714	68520000	1717	68680000	gap	160000
chr4	1718	68680000	1729	69160000	domain	480000
chr4	1730	69160000	1736	69440000	gap	280000
chr4	1737	69440000	1741	69640000	domain	200000
chr4	1742	69640000	1748	69920000	domain	280000
chr4	1749	69920000	1765	70600000	domain	680000
chr4	1766	70600000	1776	71040000	domain	440000
chr4	1777	71040000	1779	71160000	domain	120000
chr4	1780	71160000	1793	71720000	domain	560000
chr4	1794	71720000	1800	72000000	domain	280000
chr4	1801	72000000	1807	72280000	domain	280000
chr4	1808	72280000	1826	73040000	domain	760000
chr4	1827	73040000	1832	73280000	domain	240000
chr4	1833	73280000	1842	73680000	domain	400000
chr4	1843	73680000	1854	74160000	domain	480000
chr4	1855	74160000	1859	74360000	domain	200000
chr4	1860	74360000	1871	74840000	domain	480000
chr4	1872	74840000	1888	75520000	domain	680000
chr4	1889	75520000	1897	75880000	domain	360000
chr4	1898	75880000	1903	76120000	domain	240000
chr4	1904	76120000	1912	76480000	domain	360000
chr4	1913	76480000	1919	76760000	domain	280000
chr4	1920	76760000	1926	77040000	domain	280000
chr4	1927	77040000	1931	77240000	domain	200000
chr4	1932	77240000	1936	77440000	domain	200000
chr4	1937	77440000	1942	77680000	domain	240000
chr4	1943	77680000	1949	77960000	domain	280000
chr4	1950	77960000	1963	78520000	domain	560000
chr4	1964	78520000	1974	78960000	domain	440000
chr4	1975	78960000	1998	79920000	domain	960000
chr4	1999	79920000	1999	79960000	gap	40000
chr4	2000	79960000	2006	80240000	domain	280000
chr4	2007	80240000	2009	80360000	domain	120000
chr4	2010	80360000	2027	81080000	domain	720000
chr4	2028	81080000	2035	81400000	domain	320000
chr4	2036	81400000	2047	81880000	domain	480000
chr4	2048	81880000	2059	82360000	domain	480000
chr4	2060	82360000	2070	82800000	domain	440000
chr4	2071	82800000	2076	83040000	domain	240000
chr4	2077	83040000	2082	83280000	domain	240000
chr4	2083	83280000	2087	83480000	domain	200000
chr4	2088	83480000	2092	83680000	domain	200000
chr4	2093	83680000	2113	84520000	domain	840000
chr4	2114	84520000	2126	85040000	domain	520000
chr4	2127	85040000	2144	85760000	domain	720000
chr4	2145	85760000	2151	86040000	domain	280000
chr4	2152	86040000	2162	86480000	domain	440000
chr4	2163	86480000	2173	86920000	domain	440000
chr4	2174	86920000	2179	87160000	domain	240000
chr4	2180	87160000	2181	87240000	domain	80000
chr4	2182	87240000	2188	87520000	domain	280000
chr4	2189	87520000	2196	87840000	domain	320000
chr4	2197	87840000	2200	88000000	domain	160000
chr4	2201	88000000	2206	88240000	domain	240000
chr4	2207	88240000	2213	88520000	domain	280000
chr4	2214	88520000	2218	88720000	domain	200000
chr4	2219	88720000	2227	89080000	domain	360000
chr4	2228	89080000	2236	89440000	domain	360000
chr4	2237	89440000	2249	89960000	domain	520000
chr4	2250	89960000	2258	90320000	domain	360000
chr4	2259	90320000	2309	92360000	domain	2040000
chr4	2310	92360000	2331	93240000	domain	880000
chr4	2332	93240000	2345	93800000	domain	560000
chr4	2346	93800000	2356	94240000	domain	440000
chr4	2357	94240000	2379	95160000	domain	920000
chr4	2380	95160000	2452	98080000	domain	2920000
chr4	2453	98080000	2461	98440000	domain	360000
chr4	2462	98440000	2477	99080000	domain	640000
chr4	2478	99080000	2488	99520000	domain	440000
chr4	2489	99520000	2499	99960000	domain	440000
chr4	2500	99960000	2528	101120000	domain	1160000
chr4	2529	101120000	2534	101360000	domain	240000
chr4	2535	101360000	2559	102360000	domain	1000000
chr4	2560	102360000	2566	102640000	domain	280000
chr4	2567	102640000	2578	103120000	domain	480000
chr4	2579	103120000	2599	103960000	domain	840000
chr4	2600	103960000	2622	104880000	domain	920000
chr4	2623	104880000	2628	105120000	domain	240000
chr4	2629	105120000	2637	105480000	domain	360000
chr4	2638	105480000	2643	105720000	domain	240000
chr4	2644	105720000	2656	106240000	domain	520000
chr4	2657	106240000	2673	106920000	domain	680000
chr4	2674	106920000	2693	107720000	domain	800000
chr4	2694	107720000	2700	108000000	domain	280000
chr4	2701	108000000	2715	108600000	domain	600000
chr4	2716	108600000	2735	109400000	domain	800000
chr4	2736	109400000	2750	110000000	domain	600000
chr4	2751	110000000	2764	110560000	domain	560000
chr4	2765	110560000	2774	110960000	domain	400000
chr4	2775	110960000	2790	111600000	domain	640000
chr4	2791	111600000	2801	112040000	domain	440000
chr4	2802	112040000	2808	112320000	domain	280000
chr4	2809	112320000	2826	113040000	domain	720000
chr4	2827	113040000	2834	113360000	domain	320000
chr4	2835	113360000	2844	113760000	domain	400000
chr4	2845	113760000	2852	114080000	domain	320000
chr4	2853	114080000	2860	114400000	domain	320000
chr4	2861	114400000	2870	114800000	domain	400000
chr4	2871	114800000	2876	115040000	domain	240000
chr4	2877	115040000	2888	115520000	domain	480000
chr4	2889	115520000	2903	116120000	domain	600000
chr4	2904	116120000	2909	116360000	domain	240000
chr4	2910	116360000	2928	117120000	domain	760000
chr4	2929	117120000	2939	117560000	domain	440000
chr4	2940	117560000	2950	118000000	domain	440000
chr4	2951	118000000	2960	118400000	domain	400000
chr4	2961	118400000	2967	118680000	gap	280000
chr4	2968	118680000	2974	118960000	domain	280000
chr4	2975	118960000	2983	119320000	domain	360000
chr4	2984	119320000	2987	119480000	gap	160000
chr4	2988	119480000	3002	120080000	domain	600000
chr4	3003	120080000	3018	120720000	domain	640000
chr4	3019	120720000	3028	121120000	domain	400000
chr4	3029	121120000	3034	121360000	domain	240000
chr4	3035	121360000	3047	121880000	domain	520000
chr4	3048	121880000	3058	122320000	domain	440000
chr4	3059	122320000	3064	122560000	domain	240000
chr4	3065	122560000	3075	123000000	domain	440000
chr4	3076	123000000	3085	123400000	domain	400000
chr4	3086	123400000	3092	123680000	domain	280000
chr4	3093	123680000	3103	124120000	domain	440000
chr4	3104	124120000	3108	124320000	domain	200000
chr4	3109	124320000	3133	125320000	domain	1000000
chr4	3134	125320000	3145	125800000	domain	480000
chr4	3146	125800000	3154	126160000	gap	360000
chr4	3155	126160000	3158	126320000	domain	160000
chr4	3159	126320000	3159	126360000	gap	40000
chr4	3160	126360000	3169	126760000	domain	400000
chr4	3170	126760000	3176	127040000	gap	280000
chr4	3177	127040000	3191	127640000	domain	600000
chr4	3192	127640000	3196	127840000	gap	200000
chr4	3197	127840000	3204	128160000	domain	320000
chr4	3205	128160000	3211	128440000	domain	280000
chr4	3212	128440000	3222	128880000	domain	440000
chr4	3223	128880000	3231	129240000	domain	360000
chr4	3232	129240000	3258	130320000	domain	1080000
chr4	3259	130320000	3270	130800000	domain	480000
chr4	3271	130800000	3277	131080000	domain	280000
chr4	3278	131080000	3292	131680000	domain	600000
chr4	3293	131680000	3299	131960000	gap	280000
chr4	3300	131960000	3318	132720000	domain	760000
chr4	3319	132720000	3320	132800000	boundary	80000
chr4	3321	132800000	3327	133080000	domain	280000
chr4	3328	133080000	3337	133480000	domain	400000
chr4	3338	133480000	3343	133720000	domain	240000
chr4	3344	133720000	3349	133960000	domain	240000
chr4	3350	133960000	3372	134880000	domain	920000
chr4	3373	134880000	3405	136200000	domain	1320000
chr4	3406	136200000	3410	136400000	domain	200000
chr4	3411	136400000	3419	136760000	domain	360000
chr4	3420	136760000	3425	137000000	domain	240000
chr4	3426	137000000	3444	137760000	domain	760000
chr4	3445	137760000	3455	138200000	domain	440000
chr4	3456	138200000	3464	138560000	domain	360000
chr4	3465	138560000	3475	139000000	domain	440000
chr4	3476	139000000	3492	139680000	domain	680000
chr4	3493	139680000	3500	140000000	domain	320000
chr4	3501	140000000	3509	140360000	domain	360000
chr4	3510	140360000	3515	140600000	domain	240000
chr4	3516	140600000	3521	140840000	domain	240000
chr4	3522	140840000	3529	141160000	domain	320000
chr4	3530	141160000	3552	142080000	domain	920000
chr4	3553	142080000	3569	142760000	domain	680000
chr4	3570	142760000	3571	142840000	domain	80000
chr4	3572	142840000	3579	143160000	domain	320000
chr4	3580	143160000	3589	143560000	domain	400000
chr4	3590	143560000	3595	143800000	domain	240000
chr4	3596	143800000	3604	144160000	gap	360000
chr4	3605	144160000	3627	145080000	domain	920000
chr4	3628	145080000	3640	145600000	domain	520000
chr4	3641	145600000	3673	146920000	domain	1320000
chr4	3674	146920000	3678	147120000	domain	200000
chr4	3679	147120000	3690	147600000	domain	480000
chr4	3691	147600000	3697	147880000	domain	280000
chr4	3698	147880000	3727	149080000	domain	1200000
chr4	3728	149080000	3733	149320000	domain	240000
chr4	3734	149320000	3748	149920000	domain	600000
chr4	3749	149920000	3757	150280000	domain	360000
chr4	3758	150280000	3777	151080000	domain	800000
chr4	3778	151080000	3785	151400000	domain	320000
chr4	3786	151400000	3794	151760000	domain	360000
chr4	3795	151760000	3810	152400000	domain	640000
chr4	3811	152400000	3819	152760000	domain	360000
chr4	3820	152760000	3828	153120000	domain	360000
chr4	3829	153120000	3834	153360000	domain	240000
chr4	3835	153360000	3841	153640000	domain	280000
chr4	3842	153640000	3854	154160000	domain	520000
chr4	3855	154160000	3858	154320000	domain	160000
chr4	3859	154320000	3861	154440000	domain	120000
chr4	3862	154440000	3884	155360000	domain	920000
chr4	3885	155360000	3897	155880000	domain	520000
chr4	3898	155880000	3902	156080000	gap	200000
chr4	3903	156080000	3907	156280000	domain	200000
chr4	3908	156280000	3910	156400000	gap	120000
chr4	3911	156400000	3919	156760000	domain	360000
chr4	3920	156760000	3931	157240000	domain	480000
chr4	3932	157240000	3940	157600000	domain	360000
chr4	3941	157600000	3943	157720000	gap	120000
chr4	3944	157720000	3949	157960000	domain	240000
chr4	3950	157960000	3957	158280000	domain	320000
chr4	3958	158280000	3967	158680000	domain	400000
chr4	3968	158680000	3972	158880000	domain	200000
chr4	3973	158880000	3980	159200000	domain	320000
chr4	3981	159200000	3986	159440000	domain	240000
chr4	3987	159440000	3993	159720000	domain	280000
chr4	3994	159720000	3999	159960000	domain	240000
chr4	4000	159960000	4040	161600000	domain	1640000
chr4	4041	161600000	4048	161920000	domain	320000
chr4	4049	161920000	4062	162480000	domain	560000
chr4	4063	162480000	4089	163560000	domain	1080000
chr4	4090	163560000	4106	164240000	domain	680000
chr4	4107	164240000	4107	164280000	gap	40000
chr4	4108	164280000	4118	164720000	domain	440000
chr4	4119	164720000	4131	165240000	domain	520000
chr4	4132	165240000	4132	165280000	gap	40000
chr4	4133	165280000	4137	165480000	domain	200000
chr4	4138	165480000	4154	166160000	domain	680000
chr4	4155	166160000	4174	166960000	domain	800000
chr4	4175	166960000	4191	167640000	domain	680000
chr4	4192	167640000	4204	168160000	domain	520000
chr4	4205	168160000	4212	168480000	domain	320000
chr4	4213	168480000	4225	169000000	domain	520000
chr4	4226	169000000	4240	169600000	domain	600000
chr4	4241	169600000	4245	169800000	domain	200000
chr4	4246	169800000	4253	170120000	domain	320000
chr4	4254	170120000	4264	170560000	domain	440000
chr4	4265	170560000	4267	170680000	domain	120000
chr4	4268	170680000	4294	171760000	domain	1080000
chr4	4295	171760000	4301	172040000	domain	280000
chr4	4302	172040000	4324	172960000	domain	920000
chr4	4325	172960000	4338	173520000	domain	560000
chr4	4339	173520000	4354	174160000	domain	640000
chr4	4355	174160000	4358	174320000	domain	160000
chr4	4359	174320000	4367	174680000	domain	360000
chr4	4368	174680000	4383	175320000	domain	640000
chr4	4384	175320000	4389	175560000	domain	240000
chr4	4390	175560000	4398	175920000	domain	360000
chr4	4399	175920000	4409	176360000	domain	440000
chr4	4410	176360000	4427	177080000	domain	720000
chr4	4428	177080000	4436	177440000	domain	360000
chr4	4437	177440000	4439	177560000	domain	120000
chr4	4440	177560000	4466	178640000	domain	1080000
chr4	4467	178640000	4475	179000000	domain	360000
chr4	4476	179000000	4483	179320000	domain	320000
chr4	4484	179320000	4485	179400000	boundary	80000
chr4	4486	179400000	4494	179760000	domain	360000
chr4	4495	179760000	4504	180160000	domain	400000
chr4	4505	180160000	4508	180320000	domain	160000
chr4	4509	180320000	4515	180600000	domain	280000
chr4	4516	180600000	4526	181040000	domain	440000
chr4	4527	181040000	4539	181560000	domain	520000
chr4	4540	181560000	4561	182440000	domain	880000
chr4	4562	182440000	4572	182880000	domain	440000
chr4	4573	182880000	4585	183400000	domain	520000
chr4	4586	183400000	4592	183680000	domain	280000
chr4	4593	183680000	4596	183840000	domain	160000
chr4	4597	183840000	4606	184240000	domain	400000
chr4	4607	184240000	4614	184560000	domain	320000
chr4	4615	184560000	4618	184720000	domain	160000
chr4	4619	184720000	4625	185000000	domain	280000
chr4	4626	185000000	4630	185200000	domain	200000
chr4	4631	185200000	4635	185400000	domain	200000
chr4	4636	185400000	4641	185640000	domain	240000
chr4	4642	185640000	4651	186040000	domain	400000
chr4	4652	186040000	4656	186240000	domain	200000
chr4	4657	186240000	4666	186640000	domain	400000
chr4	4667	186640000	4674	186960000	domain	320000
chr4	4675	186960000	4675	187000000	gap	40000
chr4	4676	187000000	4680	187200000	domain	200000
chr4	4681	187200000	4690	187600000	domain	400000
chr4	4691	187600000	4699	187960000	domain	360000
chr4	4700	187960000	4724	188960000	domain	1000000
chr4	4725	188960000	4731	189240000	domain	280000
chr4	4732	189240000	4740	189600000	domain	360000
chr4	4741	189600000	4744	189760000	gap	160000
chr4	4745	189760000	4748	189920000	domain	160000
chr4	4749	189920000	4755	190200000	gap	280000
