chr	from.id	from.coord	to.id	to.coord	tag	size
chr12	1	0	1	40000	gap	40000
chr12	2	40000	10	400000	domain	360000
chr12	11	400000	28	1120000	domain	720000
chr12	29	1120000	40	1600000	domain	480000
chr12	41	1600000	49	1960000	domain	360000
chr12	50	1960000	67	2680000	domain	720000
chr12	68	2680000	76	3040000	domain	360000
chr12	77	3040000	83	3320000	domain	280000
chr12	84	3320000	96	3840000	domain	520000
chr12	97	3840000	102	4080000	domain	240000
chr12	103	4080000	107	4280000	domain	200000
chr12	108	4280000	113	4520000	domain	240000
chr12	114	4520000	120	4800000	domain	280000
chr12	121	4800000	128	5120000	domain	320000
chr12	129	5120000	136	5440000	domain	320000
chr12	137	5440000	148	5920000	domain	480000
chr12	149	5920000	157	6280000	domain	360000
chr12	158	6280000	165	6600000	domain	320000
chr12	166	6600000	172	6880000	domain	280000
chr12	173	6880000	180	7200000	domain	320000
chr12	181	7200000	196	7840000	domain	640000
chr12	197	7840000	204	8160000	domain	320000
chr12	205	8160000	211	8440000	gap	280000
chr12	212	8440000	216	8640000	domain	200000
chr12	217	8640000	227	9080000	domain	440000
chr12	228	9080000	232	9280000	domain	200000
chr12	233	9280000	240	9600000	gap	320000
chr12	241	9600000	255	10200000	domain	600000
chr12	256	10200000	260	10400000	domain	200000
chr12	261	10400000	261	10440000	gap	40000
chr12	262	10440000	269	10760000	domain	320000
chr12	270	10760000	277	11080000	domain	320000
chr12	278	11080000	278	11120000	gap	40000
chr12	279	11120000	282	11280000	domain	160000
chr12	283	11280000	285	11400000	gap	120000
chr12	286	11400000	301	12040000	domain	640000
chr12	302	12040000	309	12360000	domain	320000
chr12	310	12360000	319	12760000	domain	400000
chr12	320	12760000	325	13000000	domain	240000
chr12	326	13000000	331	13240000	domain	240000
chr12	332	13240000	342	13680000	domain	440000
chr12	343	13680000	354	14160000	domain	480000
chr12	355	14160000	362	14480000	domain	320000
chr12	363	14480000	368	14720000	domain	240000
chr12	369	14720000	375	15000000	domain	280000
chr12	376	15000000	382	15280000	domain	280000
chr12	383	15280000	389	15560000	domain	280000
chr12	390	15560000	398	15920000	domain	360000
chr12	399	15920000	410	16400000	domain	480000
chr12	411	16400000	422	16880000	domain	480000
chr12	423	16880000	443	17720000	domain	840000
chr12	444	17720000	451	18040000	domain	320000
chr12	452	18040000	453	18120000	boundary	80000
chr12	454	18120000	483	19320000	domain	1200000
chr12	484	19320000	492	19680000	domain	360000
chr12	493	19680000	516	20640000	domain	960000
chr12	517	20640000	531	21240000	domain	600000
chr12	532	21240000	542	21680000	domain	440000
chr12	543	21680000	551	22040000	domain	360000
chr12	552	22040000	560	22400000	domain	360000
chr12	561	22400000	561	22440000	gap	40000
chr12	562	22440000	567	22680000	domain	240000
chr12	568	22680000	615	24600000	domain	1920000
chr12	616	24600000	621	24840000	domain	240000
chr12	622	24840000	623	24920000	boundary	80000
chr12	624	24920000	629	25160000	domain	240000
chr12	630	25160000	635	25400000	domain	240000
chr12	636	25400000	652	26080000	domain	680000
chr12	653	26080000	667	26680000	domain	600000
chr12	668	26680000	671	26840000	domain	160000
chr12	672	26840000	684	27360000	domain	520000
chr12	685	27360000	693	27720000	domain	360000
chr12	694	27720000	699	27960000	domain	240000
chr12	700	27960000	704	28160000	domain	200000
chr12	705	28160000	726	29040000	domain	880000
chr12	727	29040000	733	29320000	domain	280000
chr12	734	29320000	738	29520000	domain	200000
chr12	739	29520000	771	30840000	domain	1320000
chr12	772	30840000	776	31040000	domain	200000
chr12	777	31040000	780	31200000	gap	160000
chr12	781	31200000	791	31640000	domain	440000
chr12	792	31640000	801	32040000	domain	400000
chr12	802	32040000	809	32360000	domain	320000
chr12	810	32360000	818	32720000	domain	360000
chr12	819	32720000	824	32960000	domain	240000
chr12	825	32960000	850	34000000	domain	1040000
chr12	851	34000000	859	34360000	domain	360000
chr12	860	34360000	959	38360000	gap	4000000
chr12	960	38360000	967	38680000	domain	320000
chr12	968	38680000	973	38920000	domain	240000
chr12	974	38920000	978	39120000	domain	200000
chr12	979	39120000	982	39280000	domain	160000
chr12	983	39280000	993	39720000	domain	440000
chr12	994	39720000	1003	40120000	domain	400000
chr12	1004	40120000	1015	40600000	domain	480000
chr12	1016	40600000	1023	40920000	domain	320000
chr12	1024	40920000	1032	41280000	domain	360000
chr12	1033	41280000	1041	41640000	domain	360000
chr12	1042	41640000	1042	41680000	gap	40000
chr12	1043	41680000	1051	42040000	domain	360000
chr12	1052	42040000	1061	42440000	domain	400000
chr12	1062	42440000	1084	43360000	domain	920000
chr12	1085	43360000	1093	43720000	domain	360000
chr12	1094	43720000	1099	43960000	domain	240000
chr12	1100	43960000	1124	44960000	domain	1000000
chr12	1125	44960000	1128	45120000	domain	160000
chr12	1129	45120000	1136	45440000	domain	320000
chr12	1137	45440000	1143	45720000	domain	280000
chr12	1144	45720000	1150	46000000	domain	280000
chr12	1151	46000000	1159	46360000	domain	360000
chr12	1160	46360000	1167	46680000	domain	320000
chr12	1168	46680000	1175	47000000	domain	320000
chr12	1176	47000000	1186	47440000	domain	440000
chr12	1187	47440000	1191	47640000	domain	200000
chr12	1192	47640000	1197	47880000	domain	240000
chr12	1198	47880000	1205	48200000	domain	320000
chr12	1206	48200000	1216	48640000	domain	440000
chr12	1217	48640000	1226	49040000	domain	400000
chr12	1227	49040000	1232	49280000	domain	240000
chr12	1233	49280000	1240	49600000	domain	320000
chr12	1241	49600000	1246	49840000	domain	240000
chr12	1247	49840000	1252	50080000	domain	240000
chr12	1253	50080000	1262	50480000	domain	400000
chr12	1263	50480000	1269	50760000	domain	280000
chr12	1270	50760000	1276	51040000	domain	280000
chr12	1277	51040000	1284	51360000	domain	320000
chr12	1285	51360000	1297	51880000	domain	520000
chr12	1298	51880000	1300	52000000	domain	120000
chr12	1301	52000000	1303	52120000	domain	120000
chr12	1304	52120000	1309	52360000	domain	240000
chr12	1310	52360000	1314	52560000	domain	200000
chr12	1315	52560000	1322	52880000	domain	320000
chr12	1323	52880000	1325	53000000	domain	120000
chr12	1326	53000000	1333	53320000	domain	320000
chr12	1334	53320000	1338	53520000	domain	200000
chr12	1339	53520000	1344	53760000	domain	240000
chr12	1345	53760000	1352	54080000	domain	320000
chr12	1353	54080000	1353	54120000	gap	40000
chr12	1354	54120000	1362	54480000	domain	360000
chr12	1363	54480000	1369	54760000	domain	280000
chr12	1370	54760000	1370	54800000	gap	40000
chr12	1371	54800000	1379	55160000	domain	360000
chr12	1380	55160000	1391	55640000	domain	480000
chr12	1392	55640000	1399	55960000	domain	320000
chr12	1400	55960000	1403	56120000	domain	160000
chr12	1404	56120000	1412	56480000	domain	360000
chr12	1413	56480000	1419	56760000	domain	280000
chr12	1420	56760000	1425	57000000	domain	240000
chr12	1426	57000000	1431	57240000	domain	240000
chr12	1432	57240000	1437	57480000	domain	240000
chr12	1438	57480000	1444	57760000	domain	280000
chr12	1445	57760000	1449	57960000	domain	200000
chr12	1450	57960000	1458	58320000	domain	360000
chr12	1459	58320000	1479	59160000	domain	840000
chr12	1480	59160000	1514	60560000	domain	1400000
chr12	1515	60560000	1526	61040000	domain	480000
chr12	1527	61040000	1527	61080000	gap	40000
chr12	1528	61080000	1534	61360000	domain	280000
chr12	1535	61360000	1555	62200000	domain	840000
chr12	1556	62200000	1570	62800000	domain	600000
chr12	1571	62800000	1577	63080000	domain	280000
chr12	1578	63080000	1588	63520000	domain	440000
chr12	1589	63520000	1594	63760000	gap	240000
chr12	1595	63760000	1607	64280000	domain	520000
chr12	1608	64280000	1610	64400000	domain	120000
chr12	1611	64400000	1620	64800000	domain	400000
chr12	1621	64800000	1632	65280000	domain	480000
chr12	1633	65280000	1638	65520000	domain	240000
chr12	1639	65520000	1653	66120000	domain	600000
chr12	1654	66120000	1661	66440000	domain	320000
chr12	1662	66440000	1667	66680000	domain	240000
chr12	1668	66680000	1681	67240000	domain	560000
chr12	1682	67240000	1700	68000000	domain	760000
chr12	1701	68000000	1708	68320000	domain	320000
chr12	1709	68320000	1721	68840000	domain	520000
chr12	1722	68840000	1732	69280000	domain	440000
chr12	1733	69280000	1741	69640000	domain	360000
chr12	1742	69640000	1747	69880000	domain	240000
chr12	1748	69880000	1764	70560000	domain	680000
chr12	1765	70560000	1769	70760000	domain	200000
chr12	1770	70760000	1776	71040000	domain	280000
chr12	1777	71040000	1785	71400000	domain	360000
chr12	1786	71400000	1794	71760000	domain	360000
chr12	1795	71760000	1799	71960000	domain	200000
chr12	1800	71960000	1808	72320000	domain	360000
chr12	1809	72320000	1861	74440000	domain	2120000
chr12	1862	74440000	1866	74640000	domain	200000
chr12	1867	74640000	1883	75320000	domain	680000
chr12	1884	75320000	1888	75520000	domain	200000
chr12	1889	75520000	1902	76080000	domain	560000
chr12	1903	76080000	1915	76600000	domain	520000
chr12	1916	76600000	1926	77040000	domain	440000
chr12	1927	77040000	1942	77680000	domain	640000
chr12	1943	77680000	1949	77960000	domain	280000
chr12	1950	77960000	1954	78160000	domain	200000
chr12	1955	78160000	1986	79440000	domain	1280000
chr12	1987	79440000	1987	79480000	gap	40000
chr12	1988	79480000	1994	79760000	domain	280000
chr12	1995	79760000	2011	80440000	domain	680000
chr12	2012	80440000	2012	80480000	gap	40000
chr12	2013	80480000	2020	80800000	domain	320000
chr12	2021	80800000	2032	81280000	domain	480000
chr12	2033	81280000	2041	81640000	domain	360000
chr12	2042	81640000	2059	82360000	domain	720000
chr12	2060	82360000	2069	82760000	domain	400000
chr12	2070	82760000	2070	82800000	gap	40000
chr12	2071	82800000	2111	84440000	domain	1640000
chr12	2112	84440000	2113	84520000	boundary	80000
chr12	2114	84520000	2120	84800000	domain	280000
chr12	2121	84800000	2127	85080000	domain	280000
chr12	2128	85080000	2137	85480000	domain	400000
chr12	2138	85480000	2149	85960000	domain	480000
chr12	2150	85960000	2196	87840000	domain	1880000
chr12	2197	87840000	2201	88040000	domain	200000
chr12	2202	88040000	2225	89000000	domain	960000
chr12	2226	89000000	2238	89520000	domain	520000
chr12	2239	89520000	2273	90920000	domain	1400000
chr12	2274	90920000	2284	91360000	domain	440000
chr12	2285	91360000	2304	92160000	domain	800000
chr12	2305	92160000	2317	92680000	domain	520000
chr12	2318	92680000	2324	92960000	domain	280000
chr12	2325	92960000	2336	93440000	domain	480000
chr12	2337	93440000	2344	93760000	domain	320000
chr12	2345	93760000	2353	94120000	domain	360000
chr12	2354	94120000	2363	94520000	domain	400000
chr12	2364	94520000	2376	95040000	domain	520000
chr12	2377	95040000	2384	95360000	domain	320000
chr12	2385	95360000	2389	95560000	domain	200000
chr12	2390	95560000	2397	95880000	domain	320000
chr12	2398	95880000	2406	96240000	domain	360000
chr12	2407	96240000	2414	96560000	domain	320000
chr12	2415	96560000	2425	97000000	domain	440000
chr12	2426	97000000	2435	97400000	domain	400000
chr12	2436	97400000	2451	98040000	domain	640000
chr12	2452	98040000	2460	98400000	domain	360000
chr12	2461	98400000	2467	98680000	domain	280000
chr12	2468	98680000	2475	99000000	domain	320000
chr12	2476	99000000	2494	99760000	domain	760000
chr12	2495	99760000	2509	100360000	domain	600000
chr12	2510	100360000	2519	100760000	domain	400000
chr12	2520	100760000	2535	101400000	domain	640000
chr12	2536	101400000	2544	101760000	domain	360000
chr12	2545	101760000	2547	101880000	domain	120000
chr12	2548	101880000	2554	102160000	domain	280000
chr12	2555	102160000	2571	102840000	domain	680000
chr12	2572	102840000	2589	103560000	domain	720000
chr12	2590	103560000	2604	104160000	domain	600000
chr12	2605	104160000	2610	104400000	domain	240000
chr12	2611	104400000	2627	105080000	domain	680000
chr12	2628	105080000	2635	105400000	domain	320000
chr12	2636	105400000	2655	106200000	domain	800000
chr12	2656	106200000	2659	106360000	domain	160000
chr12	2660	106360000	2674	106960000	domain	600000
chr12	2675	106960000	2678	107120000	domain	160000
chr12	2679	107120000	2691	107640000	domain	520000
chr12	2692	107640000	2698	107920000	domain	280000
chr12	2699	107920000	2713	108520000	domain	600000
chr12	2714	108520000	2722	108880000	domain	360000
chr12	2723	108880000	2727	109080000	domain	200000
chr12	2728	109080000	2735	109400000	domain	320000
chr12	2736	109400000	2745	109800000	domain	400000
chr12	2746	109800000	2748	109920000	boundary	120000
chr12	2749	109920000	2751	110040000	domain	120000
chr12	2752	110040000	2761	110440000	domain	400000
chr12	2762	110440000	2766	110640000	domain	200000
chr12	2767	110640000	2772	110880000	domain	240000
chr12	2773	110880000	2783	111320000	domain	440000
chr12	2784	111320000	2792	111680000	domain	360000
chr12	2793	111680000	2796	111840000	domain	160000
chr12	2797	111840000	2805	112200000	domain	360000
chr12	2806	112200000	2811	112440000	domain	240000
chr12	2812	112440000	2822	112880000	domain	440000
chr12	2823	112880000	2829	113160000	domain	280000
chr12	2830	113160000	2837	113480000	domain	320000
chr12	2838	113480000	2850	114000000	domain	520000
chr12	2851	114000000	2865	114600000	domain	600000
chr12	2866	114600000	2894	115760000	domain	1160000
chr12	2895	115760000	2899	115960000	domain	200000
chr12	2900	115960000	2907	116280000	domain	320000
chr12	2908	116280000	2918	116720000	domain	440000
chr12	2919	116720000	2924	116960000	domain	240000
chr12	2925	116960000	2930	117200000	domain	240000
chr12	2931	117200000	2940	117600000	domain	400000
chr12	2941	117600000	2946	117840000	domain	240000
chr12	2947	117840000	2952	118080000	domain	240000
chr12	2953	118080000	2960	118400000	domain	320000
chr12	2961	118400000	2977	119080000	domain	680000
chr12	2978	119080000	2986	119440000	domain	360000
chr12	2987	119440000	2991	119640000	domain	200000
chr12	2992	119640000	2999	119960000	domain	320000
chr12	3000	119960000	3002	120080000	domain	120000
chr12	3003	120080000	3007	120280000	domain	200000
chr12	3008	120280000	3014	120560000	domain	280000
chr12	3015	120560000	3025	121000000	domain	440000
chr12	3026	121000000	3031	121240000	domain	240000
chr12	3032	121240000	3037	121480000	domain	240000
chr12	3038	121480000	3042	121680000	domain	200000
chr12	3043	121680000	3048	121920000	domain	240000
chr12	3049	121920000	3056	122240000	domain	320000
chr12	3057	122240000	3063	122520000	domain	280000
chr12	3064	122520000	3069	122760000	domain	240000
chr12	3070	122760000	3075	123000000	domain	240000
chr12	3076	123000000	3081	123240000	domain	240000
chr12	3082	123240000	3094	123760000	domain	520000
chr12	3095	123760000	3100	124000000	domain	240000
chr12	3101	124000000	3108	124320000	domain	320000
chr12	3109	124320000	3114	124560000	domain	240000
chr12	3115	124560000	3120	124800000	domain	240000
chr12	3121	124800000	3125	125000000	boundary	200000
chr12	3126	125000000	3129	125160000	domain	160000
chr12	3130	125160000	3138	125520000	domain	360000
chr12	3139	125520000	3152	126080000	domain	560000
chr12	3153	126080000	3169	126760000	domain	680000
chr12	3170	126760000	3176	127040000	domain	280000
chr12	3177	127040000	3185	127400000	domain	360000
chr12	3186	127400000	3192	127680000	domain	280000
chr12	3193	127680000	3202	128080000	domain	400000
chr12	3203	128080000	3205	128200000	domain	120000
chr12	3206	128200000	3219	128760000	domain	560000
chr12	3220	128760000	3226	129040000	domain	280000
chr12	3227	129040000	3250	130000000	domain	960000
chr12	3251	130000000	3259	130360000	domain	360000
chr12	3260	130360000	3269	130760000	domain	400000
chr12	3270	130760000	3272	130880000	domain	120000
chr12	3273	130880000	3282	131280000	domain	400000
chr12	3283	131280000	3282	131280000	gap	0
chr12	3283	131280000	3283	131320000	gap	40000
chr12	3284	131320000	3292	131680000	domain	360000
chr12	3293	131680000	3303	132120000	domain	440000
chr12	3304	132120000	3310	132400000	domain	280000
chr12	3311	132400000	3317	132680000	domain	280000
chr12	3318	132680000	3322	132880000	domain	200000
chr12	3323	132880000	3332	133275309	domain	395309
