chr	from.id	from.coord	to.id	to.coord	tag	size
chr13	1	16000000	73	18920000	gap	2920000
chr13	74	18920000	80	19200000	domain	280000
chr13	81	19200000	89	19560000	gap	360000
chr13	90	19560000	104	20160000	domain	600000
chr13	105	20160000	112	20480000	domain	320000
chr13	113	20480000	123	20920000	domain	440000
chr13	124	20920000	132	21280000	domain	360000
chr13	133	21280000	140	21600000	domain	320000
chr13	141	21600000	159	22360000	domain	760000
chr13	160	22360000	173	22920000	domain	560000
chr13	174	22920000	174	22960000	gap	40000
chr13	175	22960000	184	23360000	domain	400000
chr13	185	23360000	197	23880000	domain	520000
chr13	198	23880000	210	24400000	domain	520000
chr13	211	24400000	211	24440000	gap	40000
chr13	212	24440000	224	24960000	domain	520000
chr13	225	24960000	225	25000000	gap	40000
chr13	226	25000000	235	25400000	domain	400000
chr13	236	25400000	253	26120000	domain	720000
chr13	254	26120000	268	26720000	domain	600000
chr13	269	26720000	273	26920000	domain	200000
chr13	274	26920000	284	27360000	domain	440000
chr13	285	27360000	301	28040000	domain	680000
chr13	302	28040000	320	28800000	domain	760000
chr13	321	28800000	335	29400000	domain	600000
chr13	336	29400000	343	29720000	domain	320000
chr13	344	29720000	353	30120000	domain	400000
chr13	354	30120000	378	31120000	domain	1000000
chr13	379	31120000	396	31840000	domain	720000
chr13	397	31840000	409	32360000	domain	520000
chr13	410	32360000	414	32560000	domain	200000
chr13	415	32560000	439	33560000	domain	1000000
chr13	440	33560000	444	33760000	domain	200000
chr13	445	33760000	479	35160000	domain	1400000
chr13	480	35160000	499	35960000	domain	800000
chr13	500	35960000	508	36320000	domain	360000
chr13	509	36320000	510	36400000	boundary	80000
chr13	511	36400000	521	36840000	domain	440000
chr13	522	36840000	527	37080000	domain	240000
chr13	528	37080000	541	37640000	domain	560000
chr13	542	37640000	565	38600000	domain	960000
chr13	566	38600000	575	39000000	domain	400000
chr13	576	39000000	592	39680000	domain	680000
chr13	593	39680000	621	40840000	domain	1160000
chr13	622	40840000	622	40880000	gap	40000
chr13	623	40880000	633	41320000	domain	440000
chr13	634	41320000	642	41680000	domain	360000
chr13	643	41680000	657	42280000	domain	600000
chr13	658	42280000	664	42560000	domain	280000
chr13	665	42560000	697	43880000	domain	1320000
chr13	698	43880000	712	44480000	domain	600000
chr13	713	44480000	725	45000000	domain	520000
chr13	726	45000000	734	45360000	domain	360000
chr13	735	45360000	738	45520000	boundary	160000
chr13	739	45520000	759	46360000	domain	840000
chr13	760	46360000	770	46800000	domain	440000
chr13	771	46800000	799	47960000	domain	1160000
chr13	800	47960000	815	48600000	domain	640000
chr13	816	48600000	820	48800000	boundary	200000
chr13	821	48800000	832	49280000	domain	480000
chr13	833	49280000	841	49640000	domain	360000
chr13	842	49640000	849	49960000	domain	320000
chr13	850	49960000	878	51120000	domain	1160000
chr13	879	51120000	883	51320000	domain	200000
chr13	884	51320000	895	51800000	domain	480000
chr13	896	51800000	905	52200000	domain	400000
chr13	906	52200000	915	52600000	gap	400000
chr13	916	52600000	931	53240000	domain	640000
chr13	932	53240000	944	53760000	domain	520000
chr13	945	53760000	960	54400000	domain	640000
chr13	961	54400000	973	54920000	domain	520000
chr13	974	54920000	983	55320000	boundary	400000
chr13	984	55320000	997	55880000	domain	560000
chr13	998	55880000	998	55920000	gap	40000
chr13	999	55920000	1012	56480000	domain	560000
chr13	1013	56480000	1014	56560000	boundary	80000
chr13	1015	56560000	1026	57040000	domain	480000
chr13	1027	57040000	1030	57200000	gap	160000
chr13	1031	57200000	1040	57600000	domain	400000
chr13	1041	57600000	1055	58200000	boundary	600000
chr13	1056	58200000	1064	58560000	boundary	360000
chr13	1065	58560000	1067	58680000	boundary	120000
chr13	1068	58680000	1072	58880000	boundary	200000
chr13	1073	58880000	1082	59280000	domain	400000
chr13	1083	59280000	1095	59800000	domain	520000
chr13	1096	59800000	1111	60440000	domain	640000
chr13	1112	60440000	1116	60640000	boundary	200000
chr13	1117	60640000	1125	61000000	domain	360000
chr13	1126	61000000	1127	61080000	boundary	80000
chr13	1128	61080000	1150	62000000	domain	920000
chr13	1151	62000000	1160	62400000	domain	400000
chr13	1161	62400000	1177	63080000	domain	680000
chr13	1178	63080000	1193	63720000	domain	640000
chr13	1194	63720000	1196	63840000	gap	120000
chr13	1197	63840000	1212	64480000	domain	640000
chr13	1213	64480000	1241	65640000	domain	1160000
chr13	1242	65640000	1282	67280000	domain	1640000
chr13	1283	67280000	1294	67760000	domain	480000
chr13	1295	67760000	1307	68280000	domain	520000
chr13	1308	68280000	1337	69480000	domain	1200000
chr13	1338	69480000	1348	69920000	domain	440000
chr13	1349	69920000	1365	70600000	domain	680000
chr13	1366	70600000	1381	71240000	domain	640000
chr13	1382	71240000	1398	71920000	domain	680000
chr13	1399	71920000	1418	72720000	domain	800000
chr13	1419	72720000	1443	73720000	domain	1000000
chr13	1444	73720000	1482	75280000	domain	1560000
chr13	1483	75280000	1489	75560000	domain	280000
chr13	1490	75560000	1492	75680000	boundary	120000
chr13	1493	75680000	1497	75880000	domain	200000
chr13	1498	75880000	1513	76520000	domain	640000
chr13	1514	76520000	1525	77000000	domain	480000
chr13	1526	77000000	1544	77760000	domain	760000
chr13	1545	77760000	1554	78160000	domain	400000
chr13	1555	78160000	1576	79040000	domain	880000
chr13	1577	79040000	1583	79320000	boundary	280000
chr13	1584	79320000	1589	79560000	domain	240000
chr13	1590	79560000	1609	80360000	domain	800000
chr13	1610	80360000	1626	81040000	domain	680000
chr13	1627	81040000	1647	81880000	domain	840000
chr13	1648	81880000	1659	82360000	domain	480000
chr13	1660	82360000	1671	82840000	domain	480000
chr13	1672	82840000	1682	83280000	domain	440000
chr13	1683	83280000	1696	83840000	domain	560000
chr13	1697	83840000	1710	84400000	domain	560000
chr13	1711	84400000	1722	84880000	domain	480000
chr13	1723	84880000	1746	85840000	domain	960000
chr13	1747	85840000	1755	86200000	domain	360000
chr13	1756	86200000	1757	86280000	gap	80000
chr13	1758	86280000	1784	87360000	domain	1080000
chr13	1785	87360000	1790	87600000	domain	240000
chr13	1791	87600000	1792	87680000	boundary	80000
chr13	1793	87680000	1827	89080000	domain	1400000
chr13	1828	89080000	1843	89720000	domain	640000
chr13	1844	89720000	1877	91080000	domain	1360000
chr13	1878	91080000	1882	91280000	domain	200000
chr13	1883	91280000	1896	91840000	domain	560000
chr13	1897	91840000	1904	92160000	domain	320000
chr13	1905	92160000	1960	94400000	domain	2240000
chr13	1961	94400000	1966	94640000	domain	240000
chr13	1967	94640000	1976	95040000	domain	400000
chr13	1977	95040000	1987	95480000	domain	440000
chr13	1988	95480000	1997	95880000	domain	400000
chr13	1998	95880000	2020	96800000	domain	920000
chr13	2021	96800000	2025	97000000	boundary	200000
chr13	2026	97000000	2036	97440000	domain	440000
chr13	2037	97440000	2046	97840000	domain	400000
chr13	2047	97840000	2061	98440000	domain	600000
chr13	2062	98440000	2071	98840000	domain	400000
chr13	2072	98840000	2077	99080000	domain	240000
chr13	2078	99080000	2086	99440000	domain	360000
chr13	2087	99440000	2091	99640000	domain	200000
chr13	2092	99640000	2115	100600000	domain	960000
chr13	2116	100600000	2128	101120000	domain	520000
chr13	2129	101120000	2146	101840000	domain	720000
chr13	2147	101840000	2164	102560000	domain	720000
chr13	2165	102560000	2172	102880000	domain	320000
chr13	2173	102880000	2179	103160000	domain	280000
chr13	2180	103160000	2196	103840000	domain	680000
chr13	2197	103840000	2264	106560000	domain	2720000
chr13	2265	106560000	2279	107160000	domain	600000
chr13	2280	107160000	2291	107640000	domain	480000
chr13	2292	107640000	2305	108200000	domain	560000
chr13	2306	108200000	2323	108920000	domain	720000
chr13	2324	108920000	2345	109800000	domain	880000
chr13	2346	109800000	2353	110120000	domain	320000
chr13	2354	110120000	2361	110440000	domain	320000
chr13	2362	110440000	2364	110560000	boundary	120000
chr13	2365	110560000	2373	110920000	domain	360000
chr13	2374	110920000	2376	111040000	boundary	120000
chr13	2377	111040000	2383	111320000	domain	280000
chr13	2384	111320000	2392	111680000	domain	360000
chr13	2393	111680000	2396	111840000	gap	160000
chr13	2397	111840000	2407	112280000	domain	440000
chr13	2408	112280000	2408	112320000	gap	40000
chr13	2409	112320000	2423	112920000	domain	600000
chr13	2424	112920000	2442	113680000	domain	760000
chr13	2443	113680000	2442	113680000	gap	0
chr13	2443	113680000	2443	113720000	gap	40000
chr13	2444	113720000	2453	114120000	domain	400000
chr13	2454	114120000	2459	114360000	domain	240000
